benign=bəˈnaɪn
little=ˈlɪd(ə)l
indium=ˈɪndiəm
transudate=ˈtrɑːnsjʊdət
hypoxaemia=ˌhaɪpɑkˈsimiə
lesion=ˈliʒ(ə)n
magnification=ˌmæɡnəfəˈkeɪʃən
ossification=ˌɑsəfəˈkeɪʃən
infraction=ᵻnˈfrækʃən
pituitary=pəˈt(j)uəˌtɛri
neurocytoma=ˌn(j)ʊroʊˌsaɪˈtoʊmə
epidural=ˌɛpəˈd(j)ʊrəl
immunocompetent=ˌɪmjənoʊˈkɑmpədənt
hepatopathy=ˌhɛpəˈtɑpəθi
xanthogranulomatous=ˌzænθoʊˌɡrænjəˈloʊmədəs
valve=vælv
normal=ˈnɔrm(ə)l
colon=ˈkoʊlən
neuroimaging=ˌn(j)ʊroʊˈɪmᵻdʒɪŋ
patellar=pəˈtɛlər
neuropathy=n(j)ʊˈrɑpəθi
weber=ˈveɪbər
medicine=ˈmɛdəs(ə)n
vasa=ˈveɪsə
hamartoma=hamɑːˈtəʊmə
osseous=ˈɑsiəs
burn=bərn
glioma=ɡlaɪˈoʊmə
solid=ˈsɑləd
exudate=ˈɛksəˌdeɪt
cavitation=kavɪˈteɪʃən
rhabdomyosarcoma=ˌræbdoʊˌmaɪoʊˌsɑrˈkoʊmə
enteropathy=ˌɛn(t)əˈrɑpəθi
lymphangitis=lɪmfanˈdʒʌɪtɪs
biliary=ˈbɪliˌɛri
coefficient=ˌkoʊəˈfɪʃənt
bear=bɛ(ə)r
splint=splɪnt
region=ˈridʒ(ə)n
glenoid=ˈɡliːnɔɪd
Cancri=ˈkæŋkri
nasopharynx=ˌneɪzoʊˈfɛrɪŋks
cistern=ˈsɪstərn
osgood-schlatter=ˌɑzˌɡʊdˈʃlɑdər
score=skɔr
fore-foot=ˈfɔrˌfʊt
band=bænd
hutchinson=ˈhʌtʃɪnsən
ileus=ˈɪliəs
marginal=ˈmɑrdʒənəl
gangrenous=ˈɡæŋɡrənəs
transplant=træn(t)sˈplænt
nitrogen=ˈnaɪtrədʒ(ə)n
mandible=ˈmændəbəl
imaging=ˈɪmɪdʒɪŋ
zollner=ˈtsœlnə
myelomata=ˌmaɪəˈloʊmədə
ring=rɪŋ
graft=ɡræft
false=fɔls
obstruction=əbˈstrəkʃən
radial=ˈreɪdiəl
asphyxiate=asˈfɪksɪeɪt
peritonsillar=ˌpɛrəˈtɑn(t)sələr
keratosis=ˌkɛrəˈtoʊsəs
luxation=ləkˈseɪʃən
breast=brɛst
heterotopia=ˌhɛdəroʊˈtoʊpiə
pigmented=pɪɡˈmɛntᵻd
roadrunner=ˈroʊdˌrənər
zenker=ˈzɛŋkər
origination=əˌrɪdʒəˈneɪʃən
broncho-pneumonia=ˌbrɑŋkoʊnəˈmoʊnjə
sphenopalatine=ˌsfinoʊˈpæləˌtaɪn
sign=saɪn
iron=ˈaɪ(ə)rn
global=ˈɡloʊb(ə)l
autosomal=ˌɔdəˈsoʊm(ə)l
severity=səˈvɛrədi
polytetrafluoroethylene=ˌpɑliˌtɛtrəˌflʊroʊˈɛθəˌlin
quantification=ˌkwɑn(t)əfəˈkeɪʃən
ming=mɪŋ
forearm=ˈfɔrˌɑrm
haemophilia=hiːməʊˈfɪlɪə
trough=trɔf
squamous=ˈskweɪməs
embolization=ˌɛmbələˈzeɪʃən
matter=ˈmædər
whom=hum
occipital=ɑkˈsɪpᵻdl
chondroma=kɑnˈdroʊmə
miriti=ˈmɪrᵻdi
protrusion=prəˈtruʒ(ə)n
muscle=ˈməs(ə)l
scintigraphy=sɪnˈtɪɡrəfi
septum=ˈsɛptəm
dilation=daɪˈleɪʃən
stripe=straɪp
pseudohypoparathyroidism=ˌsudoʊˌhaɪpoʊˌpɛrəˈθaɪrɔɪˌdɪzəm
meningeal=məˈnɪn(d)ʒiəl
angina=ænˈdʒaɪnə
resonance=ˈrɛzənən(t)s
mesentery=ˈmɛzənˌtɛri
dermatomyositis=ˌdərmədoʊˌmaɪəˈsaɪdᵻs
bleed=blid
cardiovascular=ˌkɑrdioʊˈvæskjələr
radiology=ˌreɪdiˈɑlədʒi
vasculitis=vaskjʊˈlʌɪtɪs
ten=tɛn
scaphoid=ˈskæˌfɔɪd
haematopoiesis=ˌhimədoʊˌpɔɪˈisᵻs
skin=skɪn
recovery=rəˈkəv(ə)ri
sesamoid=ˈsɛsəˌmɔɪd
signet=ˈsɪɡnᵻt
rete=ˈridi
leveche=lɛˈbɛtʃɛ
retia=ˈridiə
cribriform=ˈkrɪbrɪfɔːm
aorta=eɪˈɔrdə
duplication=ˌd(j)upləˈkeɪʃən
channel=ˈtʃæn(ə)l
seronegative=ˌsɪroʊˈnɛɡədɪv
aneurysm=ˈænjəˌrɪzəm
oropharynx=ˌɔroʊˈfɛrɪŋks
neuroenteric=ˌn(j)ʊroʊənˈtɛrɪk
overload=ˈoʊvərˌloʊd
obturator=ˈɑbt(j)əˌreɪdər
oriental=ˌɔriˈɛn(t)l
multinodular=ˌməltiˈnɑdʒələr
sacro-coccygeal=ˌseɪkroʊˌkɑkˈsɪdʒiəl
apparent=əˈpɛrənt
atoll=ˈæˌtɔl
wilson=ˈwɪls(ə)n
condition=kənˈdɪʃən
recall=rəˈkɔl
nasopharynges=ˌneɪzoʊfəˈrɪndʒiz
fistula=ˈfɪstʃələ
alpha=ˈælfə
fluoroscopy=flʊˈrɑskəpi
string=strɪŋ
march=mɑrtʃ
optic=ˈɑptɪk
appendicitis=əˌpɛndəˈsaɪdᵻs
to=tu
ranula=ˈrænjələ
adnexa=ædˈnɛksə
ghost=ɡoʊst
accord=əˈkɔrd
tomography=toʊˈmɑɡrəfi
mediastinitis=ˌmidiəstəˈnaɪdᵻs
zygomycetes=ˌzaɪɡəˌmaɪˈsidiz
echo=ˈɛkoʊ
subperiosteal=ˌsəbˌpɛriˈɑstiəl
mr=ˈmɪstər
leave=liv
carpal=ˈkɑːpəl
prostatic=prɑˈstædɪk
punctate=ˈpəŋ(k)ˌteɪt
intervention=ˌɪn(t)ərˈvɛn(t)ʃ(ə)n
thymic=ˈθaɪmɪk
common=ˈkɑmən
sawst=sɔst
panda=ˈpændə
barrette=bəˈrɛt
masticator=ˈmæstəˌkeɪdər
regional=ˈridʒ(ə)nəl
report=rəˈpɔrt
waist=weɪst
haemosiderosis=ˌhiməˌsɪdəˈroʊsəs
paratracheal=ˌpɛrəˈtreɪkiəl
epidermoid=ɛpɪˈdəːmɔɪd
cookie=ˈkʊki
intercostal=ˌɪn(t)ərˈkɑstəl
half=hæf
reversible=rəˈvərsəb(ə)l
toxic=ˈtɑksɪk
middle=ˈmɪd(ə)l
surgery=ˈsərdʒ(ə)ri
conception=kənˈsɛpʃən
perivascular=ˌpɛrəˈvæskjələr
study=ˈstədi
cumulative=ˈkjumjələdɪv
identical=aɪˈdɛn(t)ək(ə)l
spinnaker=ˈspɪnəkər
malignancy=məˈlɪɡnən(t)si
cirrhosis=səˈroʊsəs
mycobacterium=ˌmaɪkoʊˌbækˈtɪriəm
gastronome=ˈɡæstrəˌnoʊm
larix=ˈlarɪks
intra-uterine=ˌɪntrəˈjudərən
far=fɑr
glen=ɡlɛn
ductal=ˈdəkt(ə)l
pneumonitis=ˌn(j)uməˈnaɪdᵻs
infection=ᵻnˈfɛkʃən
mastopathy=mæˈstɑpəθi
left-sided=ˈlɛf(t)ˌsaɪdᵻd
quench=kwɛn(t)ʃ
prognosis=prɑɡˈnoʊsəs
visceral=ˈvɪs(ə)rəl
anode=ˈænəʊd
sciatic=saɪˈædɪk
arthritis=ɑrˈθraɪdᵻs
acrogenic=ˌækrəˈdʒɛnɪk
dosimetry=dəʊˈsɪmɪtrɪ
longitudinal=ˌlɔndʒəˈt(j)udənl
compton=ˈkɒm(p)tən
cerebro-spinal=səˌribroʊˈspaɪn(ə)l
pump=pəmp
tracheostomy=ˌtreɪkiˈɑstəmi
degeneration=dəˌdʒɛnəˈreɪʃən
proton=ˈproʊˌtɑn
cholesteatoma=kəˌlɛstiəˈtoʊmə
attenuation=əˌtɛnjʊˈeɪʃən
coat=koʊt
pneumonia=nəˈmoʊnjə
chariot=ˈtʃɛriət
adenosis=ˌædnˈoʊsəs
myxoid=ˈmɪkˌsɔɪd
syndrome=ˈsɪnˌdroʊm
navicular=nəˈvɪkjələr
round=raʊnd
hypogenesis=ˌhaɪpəˈdʒɛnəsəs
apex=ˈeɪˌpɛks
tiger=ˈtaɪɡər
fire=ˈfaɪ(ə)r
ophthalmopathy=ˌɑpθə(l)ˈmɑpəθi
cochlear=ˈkoʊkliər
pseudotumour=ˈsudoʊˌt(j)umər
pneumocystis=ˌn(j)umoʊˈsɪstᵻs
distress=dəˈstrɛs
mechanism=ˈmɛkəˌnɪzəm
tuberculous=təˈbərkjələs
emesis=ˈɛmɪsɪs
dopa=ˈdoʊpə
malfunction=mælˈfəŋ(k)ʃən
radiation=ˌreɪdiˈeɪʃən
wilms=vɪlmz
ballota=bəˈloʊdə
hydrome=ˈhʌɪdrəʊm
fossae=ˈfɔsi
dementia=dəˈmɛn(t)ʃ(i)ə
gradient=ˈɡreɪdiənt
nasopharyngeal=ˌneɪzoʊfəˈrɪndʒ(i)əl
bead=bid
triquetral=traɪˈkwitrəl
buerger=ˈbəːɡə
axis=ˈæksəs
pulmonary=ˈpəlməˌnɛri
myocardial=ˌmaɪoʊˈkɑrdiəl
variant=ˈvɛriənt
leukaemia=luˈkimiə
hump=həmp
stool=stul
hydrometer=hʌɪˈdrɒmɪtə
therapy=ˈθɛrəpi
peripharyngeal=ˌpɛrəfəˈrɪndʒ(i)əl
kyphosis=kaɪˈfoʊsəs
tuberculosis=təˌbərkjəˈloʊsəs
odontoid=oʊˈdɑnˌtɔɪd
prosthesis=prɑsˈθisəs
risk=rɪsk
agenesis=eɪˈdʒɛnəsəs
femur=ˈfimər
metabolic=ˌmɛdəˈbɑlɪk
arborescent=ɑːbəˈrɛsənt
astrocyte=ˈæstrəˌsaɪt
atonal=eɪˈtəʊnəl
choana=ˈkəʊənə
chondrosarcoma=ˌkɑndroʊˌsɑrˈkoʊmə
fluid=ˈfluɪd
date=deɪt
left=lɛft
metastases=məˈtæstəsiz
glial=ˈɡliəl
soap-bubble=ˈsoʊp ˌbəb(ə)l
filter=ˈfɪltər
light-bulb=ˈlaɪt ˌbəlb
background=ˈbækˌɡraʊnd
posterior=pɑˈstɪriər
mammography=mæˈmɑɡrəfi
epicardial=ˌɛpəˈkɑrdiəl
calcaneal=kalˈkeɪnɪəl
adonis=əˈdɑnəs
paraduodenal=ˌpɛrəˌd(j)uəˈdin(ə)l
marquis=mɑrˈki
delta=ˈdɛltə
arthropathy=ɑrˈθrɑpəθi
acute=əˈkjut
anastomotic=əˌnæstəˈmɒtɪk
cuff=kəf
chagal=ˈtʃɑːɡəl
medium=ˈmidiəm
hepatocellular=ˌhɛpədoʊˈsɛljələr
magnetic=mæɡˈnɛdɪk
silicosis=sɪlɪˈkəʊsɪs
hashimoto=ˌhæʃiˈmoʊdoʊ
congenital=kənˈdʒɛnəd(ə)l
sample=ˈsæmp(ə)l
hypertensive=ˌhaɪpərˈtɛn(t)sɪv
tingle=ˈtɪŋɡ(ə)l
refraction=rəˈfrækʃən
adenoma=ˌædnˈoʊmə
lobar=ˈloʊˌbɑr
central=ˈsɛntrəl
neuromyositis=ˌn(j)ʊroʊˌmaɪəˈsaɪdᵻs
osteoma=ˌɑstiˈoʊmə
bosniak=ˈbɑzniˌæk
emphysematous=ˌɛmfəˈzimədəs
duct=dək(t)
mnemonic=nəˈmɑnɪk
cytotoxic=ˌsaɪdəˈtɑksɪk
rectius=ˈrɛktiəs
football=ˈfʊtˌbɔl
affect=əˈfɛk(t)
mucous=ˈmjukəs
pneumatocele=n(j)uˈmædəˌsil
reflux=ˈriˌfləks
aida=aɪˈidə
spatial=ˈspeɪʃ(ə)l
retroperitoneal=ˌrɛtroʊˌpɛrətnˈiəl
microscopic=ˌmaɪkrəˈskɑpɪk
windblow=ˈwɪn(d)ˌbloʊ
pharyngocele=fəˈrɪŋɡəˌsil
limp=lɪmp
rolando=roʊˈlændoʊ
bronchiolitis=brɒŋkɪəʊˈlʌɪtɪs
angiographic=ˌændʒiəˈɡræfɪk
exposure=ɪkˈspoʊʒər
vena=ˈvinə
early=ˈərli
space=speɪs
neurenteric=ˌn(j)ʊrənˈtɛrɪk
obturate=ˈɑbt(j)əˌreɪt
phenomenon=fəˈnɑməˌnɑn
extrarenal=ˌɛkstrəˈrin(ə)l
aortitis=eɪɔːˈtʌɪtɪs
torticollis=tɔːtɪˈkɒlɪs
correlation=ˌkɔrəˈleɪʃən
reactive=riˈæktɪv
angle=ˈæŋɡ(ə)l
compression=kəmˈprɛʃən
schmoll=ʃmɑl
pterygomaxillary=ˌtɛrəɡoʊˈmæksəˌlɛri
distribution=ˌdɪstrəˈbjuʃən
seminoma=sɛmɪˈnəʊmə
lobular=ˈlɑbjələr
aqueduct=ˈɑkwəˌdək(t)
nipple=ˈnɪp(ə)l
urothelial=ˌjʊrəˈθiliəl
handle=ˈhændəl
inguinal=ˈɪŋɡwən(ə)l
shin=ʃɪn
diagnosis=ˌdaɪəɡˈnoʊsəs
haemorrhoidal=hɛməˈrɔɪdəl
cava=ˈkɑvə
arch=ɑrtʃ
chloroma=klɒˈrəʊmə
amyloid=ˈæmɪlɔɪd
bennet=ˈbɛnət
screening=ˈskrinɪŋ
dehiscent=dɪˈhɪsənt
poland=ˈpoʊlən(d)
recess=ˈriˌsɛs
body=ˈbɑdi
granulomatosis=ˌɡranjʊˌləʊməˈtəʊsɪs
capture=ˈkæp(t)ʃər
plate=pleɪt
arcuate=ˈɑːkjuːət
hockey=ˈhɑki
bicep=ˈbaɪˌsɛp
antigen=ˈæn(t)ədʒən
jet=dʒɛt
diabetic=ˌdaɪəˈbɛdɪk
conjoin=kənˈdʒɔɪn
oesophagus=əˈsɑfəɡəs
pylorospasm=paɪˈlɔrəˌspæzəm
intracapsular=ˌɪntrəˈkæps(j)ələr
myelomeningocele=ˌmaɪəloʊməˈnɪŋɡoʊˌsil
kidney=ˈkɪdni
compute=kəmˈpjut
transducer=trænzˈd(j)usər
monoxide=məˈnɑkˌsaɪd
porcelain=ˈpɔrs(ə)lən
gist=dʒɪst
fontal=ˈfɑn(t)l
scatter=ˈskædər
tether=ˈtɛðər
multicentric=ˌməltiˈsɛntrɪk
pancoast=ˈpænˌkoʊst
tumour=ˈt(j)umər
air=ɛ(ə)r
iatrogenic=ʌɪˌatrəʊˈdʒɛnɪk
myometrium=ˌmaɪoʊˈmitriəm
thrower=ˈθroʊər
butterfly=ˈbədərˌflaɪ
saprophytic=-ˈfɪtɪk
sigmoid=ˈsɪɡˌmɔɪd
urethra=jʊˈriθrə
panner=ˈpænər
swell=swɛl
fag=fæɡ
calculous=ˈkalkjʊləs
reverse=rəˈvərs
clear=klɪ(ə)r
retinopathy=ˌrɛtnˈɑpəθi
buckle=ˈbək(ə)l
leak=lik
tuberculoma=təˌbərkjəˈloʊmə
phyllode=ˈfɪˌloʊd
invert=ᵻnˈvərt
base=beɪs
infantile=ˈɪnfənˌtaɪl
peptic=ˈpɛptɪk
rupture=ˈrəp(t)ʃər
wave=weɪv
stent=stɛnt
recurrent=rəˈkərənt
lateral=ˈlædərəl
paediatric=ˌpidiˈætrɪk
osteopetrosis=ˌɑstioʊpəˈtroʊsəs
hyperphosphataemia=ˌhaɪpərˌfɑsfəˈtimiə
abdomen=ˈæbdəmən
perfusion=pərˈfjuʒ(ə)n
return=rəˈtərn
fournier=ˈfʊənɪeɪ
myositis=ˌmaɪoʊˈsaɪdᵻs
laryngeal=ləˈrɪndʒ(i)əl
heat=hit
cholestatic=ˌkoʊləˈstædɪk
ureteritis=ˌjʊrədəˈraɪdᵻs
radiographic=ˌreɪdiəˈɡræfɪk
descend=dəˈsɛnd
hyperparathyroidism=ˌhaɪpərˌpɛrəˈθaɪrɔɪˌdɪzəm
branchial=ˈbræŋkiəl
membrane=ˈmɛmˌbreɪn
relapse=rəˈlæps
transformation=ˌtræn(t)sfərˈmeɪʃən
phlegmon=ˈflɛɡˌmɑn
sclerosis=skləˈroʊsəs
breastfeeding=ˈbrɛs(t)ˌfidɪŋ
osteochondral=ˌɑstioʊˈkɑndrəl
non-luminous=ˌnɑnˈlumənəs
intracardiac=ˌɪntrəˈkɑrdiˌæk
malformation=ˌmælfɔrˈmeɪʃən
scleroderma=sklɪərəʊˈdəːmə
torcular=ˈtɔːkjuːlə
inferior=ᵻnˈfɪriər
satchel=ˈsætʃ(ə)l
quadrigeminal=ˌkwɑdrəˈdʒɛmən(ə)l
perch=pərtʃ
pericardium=ˌpɛrəˈkɑrdiəm
monoamniotic=ˌmɑnoʊˌæmniˈɑdɪk
fibro-cystic=ˌfaɪbrəˈsɪstɪk
finger=ˈfɪŋɡər
cerebellar=ˌsɛrəˈbɛlər
biceps=ˈbaɪˌsɛps
abuse=əˈbjus
absorption=əbˈzɔrpʃən
balao=bəˈlaʊ
iliac=ˈɪliˌæk
bony=ˈboʊni
coeliac=ˈsiːlɪak
basal=ˈbeɪs(ə)l
fallopian=fəˈloʊpiən
fibroid=ˈfaɪˌbrɔɪd
shish=ʃɪʃ
device=dəˈvaɪs
upper=ˈəpər
diaschisis=dʌɪˈaskɪsɪs
urachal=ˈjʊrək(ə)l
epiphyseal=ɛpɪˈfɪzɪəl
orbit=ˈɔrbət
connection=kəˈnɛkʃən
siderosis=ˌsɪdəˈroʊsəs
window=ˈwɪndoʊ
mimic=ˈmɪmɪk
dural=ˈdjʊərəl
ischaemia=ɪsˈkimiə
nephropathy=nəˈfrɑpəθi
occlusion=əˈkluʒ(ə)n
neoplasm=ˈniəˌplæzəm
bump=bəmp
concentric=kənˈsɛntrɪk
scar=skɑr
vocal=ˈvoʊk(ə)l
anomalous=əˈnɑmələs
transposition=ˌtræn(t)spəˈzɪʃən
pain=peɪn
quadrilateral=ˌkwɑdrəˈlædər(ə)l
grizzle=ˈɡrɪz(ə)l
frequency=ˈfrikwən(t)si
urography=jʊˈrɒɡrəfi
monocystic=ˌmɑnəˈsɪstɪk
old-nick=ˌoʊl(d) ˈnɪk
dissection=dəˈsɛkʃən
tee=ti
stage=steɪdʒ
thromboembolic=ˌθrɑmboʊˌɛmˈbɑlɪk
serous=ˈsɪrəs
dna=ˌdiˌɛnˈeɪ
dysplastic=dɪˈsplastɪk
single=ˈsɪŋɡ(ə)l
entrapment=ᵻnˈtræpmənt
therapeutic=ˌθɛrəˈpjudɪk
tamoxifen=təˈmɒksɪfɛn
ball=bɔl
bunch=bən(t)ʃ
plateaux=plæˈtoʊ
neurogenic=ˌn(j)ʊroʊˈdʒɛnɪk
osteoclastoma=ˌɑstioʊˌklæˈstoʊmə
pregnancy=ˈprɛɡnən(t)si
pip=pɪp
lyriform=ˈlʌɪərɪfɔːm
fibro-vascular=ˌfaɪbroʊˈvæskjələr
sawest=ˈsɔᵻst
periostitis=ˌpɛriˌɑsˈtaɪdᵻs
ivy=ˈaɪvi
thalassaemia=θaləˈsiːmɪə
bubble=ˈbəb(ə)l
adventitial=ˌædˌvɛnˈtɪʃəl
heart=hɑrt
poisoning=ˈpɔɪzn̩ɪŋ
callosal=kəˈloʊs(ə)l
musculoskeletal=ˌməskjəloʊˈskɛlədl
concern=kənˈsərn
petrous=ˈpɛtrəs
protocol=ˈproʊdəˌkɔl
pseudocyst=ˈsudoʊˌsɪst
children=ˈtʃɪldr(ə)n
torch=tɔrtʃ
hypersensitivity=ˌhaɪpərˌsɛn(t)səˈtɪvᵻdi
hyperplasia=ˌhaɪpərˈpleɪʒ(i)ə
apgar=ˈapɡə
dominant=ˈdɑmənənt
humeral=ˈhjuːmərəl
saccular=ˈsakjʊlə
neonate=ˈniəˌneɪt
regurgitation=rəˌɡərdʒəˈteɪʃən
factor=ˈfæktər
adrenal=əˈdrin(ə)l
monochorionic=ˌmɑnəˌkoʊriˈɑnɪk
triplane=ˈtraɪˌpleɪn
pulvinar=pəlˈvaɪnər
precardiac=priˈkɑrdiˌæk
labrum=ˈleɪbrəm
galaxy=ˈɡæləksi
baker=ˈbeɪkər
life=laɪf
capital=ˈkæpədl
sleeve=sliv
adenopathy=ˌædnˈɑpəθi
benison=ˈbɛnɪsən
ileal=ˈɪliəl
intramural=ˌɪntrəˈmjʊrəl
twin=twɪn
bihari=bɪˈhɑːri
exostosis=ɛksɒˈstəʊsɪs
hereditary=həˈrɛdəˌtɛri
equivalent=əˈkwɪv(ə)lənt
mallet=ˈmælət
duodenal=ˌd(j)uəˈdin(ə)l
jersey=ˈdʒərzi
rosary=ˈroʊz(ə)ri
au-fond=əʊ ˈfɒ̃
acquire=əˈkwaɪ(ə)r
pancreas=ˈpæŋkriəs
biparietal=ˌbʌɪpəˈrʌɪɪtəl
neuritis=n(j)ʊˈraɪdᵻs
transient=ˈtræn(t)ʃənt
sarcoma=sɑrˈkoʊmə
blastema=blaˈstiːmə
retinoblastoma=ˌrɛtn̩oʊˌblæˈstoʊmə
nephroid=ˈnɛˌfrɔɪd
fat=fæt
allision=əˈlɪʒ(ə)n
vagina=vəˈdʒaɪnə
luteal=ˈludiəl
postmenopausal=ˌpoʊs(t)ˌmɛnəˈpɔzl
chance=tʃæn(t)s
rubidium=ruˈbɪdiəm
scrotal=ˈskrəʊtəl
prosthetic=prɑsˈθɛdɪk
erosion=əˈroʊʒ(ə)n
kebab=kəˈbɑb
sinus=ˈsaɪnəs
broncho-pulmonary=ˌbrɑŋkoʊˈpəlməˌnɛri
deep=dip
haemochromatosis=ˌhiməˌkroʊməˈtoʊsəs
of=əv
multilocular=ˌməltiˈlɑkjələr
cephalocele=ˈsɛfələˌsil
immunocompromised=ˌɪmjənoʊˈkɑmprəˌmaɪzd
superdense=ˌsupərˈdɛn(t)s
subclavian=ˌsəbˈkleɪviən
bundle=ˈbənd(ə)l
carcinoma=ˌkɑrsəˈnoʊmə
internal=ᵻnˈtərnəl
perilymphatic=ˌpɛrəlɪmˈfædɪk
myelofibrosis=ˌmaɪəloʊˌfaɪˈbroʊsəs
complicate=ˈkɑmpləˌkeɪt
helicobacter=ˈhɛləkəˌbæktər
eggshell=ˈɛɡˌʃɛl
from=frəm
divisor=dɪˈvʌɪzə
mesothelioma=ˌmɛzoʊˌθiliˈoʊmə
desmoid=ˈdɛsmɔɪd
enlarge=ᵻnˈlɑrdʒ
bronchiectasis=ˌbrɒŋkɪˈɛktəsɪs
pyelonephritis=ˌpaɪloʊnəˈfraɪdəs
product=ˈprɑˌdək(t)
kangaroo=ˌkæŋɡəˈru
corkscrew=ˈkɔrkˌskru
scan=skæn
sequestration=siːkwɛˈstreɪʃən
matrix=ˈmeɪtrɪks
osteochondrosis=ˌɑstioʊˌkɑnˈdroʊsəs
rib=rɪb
tissue=ˈtɪʃu
prosencephalon=ˌprɑsnˈsɛfəˌlɑn
hirschsprung=ˈhɪəʃprʊŋ
mucopolysaccharidoses=ˌmjukoʊˌpɑliˌsækəˌraɪˈdoʊsiz
infiltration=ˌɪnfɪlˈtreɪʃən
delay=dəˈleɪ
ear=ɪ(ə)r
skull=skəl
gastritis=ɡæˈstraɪdᵻs
total=ˈtoʊd(ə)l
haematosalpinx=ˌhimədoʊˈsælˌpɪŋ(k)s
undifferentiated=ˌənˌdɪfəˈrɛnʃiˌeɪdᵻd
pattern=ˈpædərn
perforation=ˌpərfəˈreɪʃən
flexion=ˈflɛkʃən
mouth=maʊθ
oncogenic=ˌɔnkoʊˈdʒɛnɪk
infarction=ᵻnˈfɑrkʃən
embryonal=ɛmˈbraɪən(ə)l
myeloma=ˌmaɪəˈloʊmə
matrices=ˈmeɪtrəˌsiz
mucoepidermoid=ˌmjukoʊˌɛpəˈdərˌmɔɪd
oncologic=ˌɑnkoʊˈlɑdʒɪk
heal=hil
subcortical=ˌsəbˈkɔrdək(ə)l
lumbar=ˈləmˌbɑr
axillary=ækˈsɪləri
transfusion=ˌtræn(t)sˈfjuʒən
aspirate=ˈæspəˌreɪt
placentation=ˌplæs(ə)nˈteɪʃən
candida=ˈkændɪdə
synovial=səˈnoʊviəl
otitis=oʊˈtaɪdᵻs
epiglottitis=ˌɛpɪɡlɒˈtʌɪtɪs
barrow=ˈbɛroʊ
decay=dəˈkeɪ
reduction=rəˈdəkʃən
intracranial=ˌɪntrəˈkreɪniəl
polyarteritis=ˌpɑliˌɑrdəˈraɪdᵻs
canal=kəˈnæl
wernicke=ˈvəːnɪkə
damage=ˈdæmɪdʒ
croup=krup
category=ˈkædəˌɡɔri
subtype=ˈsəbˌtaɪp
cavernous=ˈkævərnəs
lymphatic=lɪmˈfædɪk
mesenchymal=mɛˈzɛŋkəm(ə)l
spondylolysis=spɒndɪˈlɒlɪsɪs
arachnoiditis=əˌrækˌnɔɪˈdaɪdᵻs
hiatal=hʌɪˈeɪtəl
aspergillus=ˌæspərˈdʒɪləs
nephrocalcinosis=ˌnɛfroʊˌkælsəˈnoʊsəs
brain=breɪn
post-surgical=ˌpoʊs(t)ˈsərdʒək(ə)l
encephalitis=ᵻnˌsɛfəˈlaɪdəs
coarctation=kəʊɑːkˈteɪʃən
architectural=ˌɑrkəˈtɛk(t)ʃ(ə)rəl
stridor=ˈstrʌɪdə
nervous=ˈnərvəs
replace=rəˈpleɪs
inhibitor=ᵻnˈhɪbədər
hand=hænd
anaplastic=ænəˈplɑːstɪk
plain=pleɪn
also=ˈɔlsoʊ
appendicitises=əˌpɛndəˈsaɪdᵻsəz
immaturity=ˌɪməˈtʊrədi
hunt=hənt
pathway=ˈpæθˌweɪ
occlusive=əˈklusɪv
carbon=ˈkɑrbən
ankle=ˈæŋk(ə)l
omphalocele=ˈɑmfələˌsil
ollier=ˈɑljər
obstructive=əbˈstrəktɪv
peritoneal=ˌpɛrətnˈiəl
adenomatous=ˌædnˈoʊmədəs
mucopolysaccharidosis=ˌmjukoʊˌpɑliˌsækəˌraɪˈdoʊsəs
sclerosing=sklɪəˈrəʊsɪŋ
labral=ˈleɪbrəl
dermoid=ˈdəːmɔɪd
criton=ˈkrɪtn
mass=mæs
fallot=fæˈloʊ
la-bas=ˌlɑˈbɑ
lung=ləŋ
polymyositis=ˌpɑliˌmaɪoʊˈsaɪdᵻs
medulloblastoma=məˌdəloʊˌblæˈstoʊmə
iodine=ˈaɪəˌdaɪn
plexus=ˈplɛksəs
wire=ˈwaɪ(ə)r
cortical=ˈkɔrdək(ə)l
manoeuvre=məˈn(j)uvər
torsion=ˈtɔrʃən
retain=rəˈteɪn
zone=zoʊn
gastric=ˈɡæstrɪk
zonal=ˈzoʊn(ə)l
olfactory=ɑlˈfækt(ə)ri
hernia=ˈhərniə
epithelioid=ɛpɪˈθiːlɪɔɪd
thrombosis=ˌθrɑmˈboʊsəs
physics=ˈfɪzɪks
nephrogenic=ˌnɛfroʊˈdʒɛnɪk
hygroma=hʌɪˈɡrəʊmə
statistics=stəˈtɪstɪks
spinal=ˈspaɪn(ə)l
doppler=ˈdɑplər
periosteal=ˌpɛriˈɑstiəl
hydrocele=ˈhʌɪdrəʊsiːl
pancreaticoduodenal=ˌpæŋkriˌædəkoʊˌd(j)uəˈdin(ə)l
osteitis=ˌɑstiˈaɪdəs
small=smɔl
hydroxyapatite=hʌɪˌdrɒksɪˈapətʌɪt
lingual=ˈlɪŋɡwəl
bicipites=ˌbaɪˈsɪpᵻdiz
cystic=ˈsɪstɪk
ureterocele=jʊˈridərəˌsil
disc=dɪsk
discoid=ˈdɪˌskɔɪd
facial=ˈfeɪʃ(ə)l
corundum=kɒˈrʌndəm
corner=ˈkɔrnər
month=mənθ
form=frəm
multifactorial=ˌməltiˌfækˈtɔriəl
intussusception=ˌɪntəssəˈsɛpʃən
tracheobronchial=ˌtreɪkioʊˈbrɑŋkiəl
control=kənˈtroʊl
wavelength=ˈweɪvˌlɛŋ(k)θ
michael=ˈmaɪk(ə)l
soft=sɔft
petit=ˈpɛdi
pancreatic=ˌpæŋkriˈædɪk
aberrant=ˈæbərənt
crazy=ˈkreɪzi
sausage=ˈsɔsɪdʒ
myolipoma=ˌmaɪoʊləˈpoʊmə
ligamentum=ˌlɪɡəˈmɛntəm
mono=ˈmoʊnoʊ
bamboo=ˌbæmˈbu
still=stɪl
osteoporosis=ˌɑstioʊpəˈroʊsəs
patinaed=pəˈtinəd
cerebral=səˈribrəl
radiography=ˌreɪdiˈɑɡrəfi
takayasu=takəˈjasuː
stomach=ˈstəmək
shepherd=ˈʃɛpərd
superficial=ˌsupərˈfɪʃəl
epididymo=ˌɛpəˌdɪdəmoʊɔrˈkaɪdᵻs
osteoarthropathy=ˌɑstioʊˌɑrˈθrɑpəθi
hypothenar=haɪˈpɑθənər
ureter=ˈjʊrədər
veno-occlusive=ˌvinoʊəˈklusɪv
prostate=ˈprɑˌsteɪt
adenomyosis=ˌædn̩oʊˌmaɪˈoʊsəs
urethral=jʊˈriθrəl
currant=ˈkərənt
pinocytic=ˌpɪnəˈsɪdɪk
bronchial=ˈbrɑŋkiəl
childhood=ˈtʃaɪl(d)ˌ(h)ʊd
roc=rɑk
haemangioma=ˌhiːmandʒɪˈəʊmə
implant=ᵻmˈplænt
image=ˈɪmɪdʒ
electron=əˈlɛkˌtrɑn
disruption=dɪsˈrəpʃən
nephrostomy=nəˈfrɑstəmi
volar=ˈvoʊlər
male=meɪl
labyrinthitis=ˌlæb(ə)ˌrɪnˈθaɪdᵻs
lytic=ˈlɪdɪk
target=ˈtɑrɡət
bulge=bəldʒ
noise=nɔɪz
multifocal=ˌməltiˈfoʊk(ə)l
functional=ˈfəŋ(k)ʃ(ə)nəl
corpus=ˈkɔrpəs
mag=mæɡ
syphilis=ˈsɪf(ə)lᵻs
safe=seɪf
solitary=ˈsɑləˌtɛri
linear=ˈlɪniər
wing=wɪŋ
coronary=ˈkɔrəˌnɛri
hyperacute=ˌhaɪpərəˈkjut
diverticulum=ˌdaɪvərˈtɪkjələm
notch=nɑtʃ
tracheal=ˈtreɪkiəl
vicat=ˈviːkɑː
vesico-ureteral=ˌvɛsəkoʊˌjʊˈridərəl
aspergillosis=aspədʒɪˈləʊsɪs
proximal=ˈprɑksəm(ə)l
paw=pɔ
atrophy=ˈætrəfi
definition=ˌdɛfəˈnɪʃən
yolk=joʊk
osmotic=ɑzˈmɑdɪk
tachypnoea=ˌtækə(p)ˈniə
associate=əˈsoʊsiˌeɪt
gate=ɡeɪt
hyperostosis=ˌhʌɪpərɒˈstəʊsɪs
lacrimal=ˈlækrəməl
acromial=əˈkroʊmiəl
pseudocirrhosis=ˌsudoʊsəˈroʊsəs
stability=stəˈbɪlᵻdi
liver=ˈlɪvər
leiomyoma=ˌlaɪoʊmaɪˈoʊmə
cholangitis=ˌkoʊlənˈdʒaɪdᵻs
pellucidly=pəˈl(j)usədli
saline=ˈseɪˌlin
cavitary=ˈkavɪtəri
signal=ˈsɪɡn(ə)l
mastitis=mæˈstaɪdᵻs
reiter=ˈraɪdər
osteophytosis=ˌɑstioʊˌfaɪˈtoʊsəs
monozygotic=ˌmɑnəˌzaɪˈɡɑdɪk
subendocardial=ˌsəbˌɛndəˈkɑrdiəl
asymmetry=eɪˈsɪmətri
ectopic=ɛkˈtɑpɪk
sickle=ˈsɪk(ə)l
oligodendroglioma=ˌɑləɡoʊˌdɛndroʊˌɡlaɪˈoʊmə
plug=pləɡ
classification=ˌklæsəfəˈkeɪʃən
on=ɔn
prune=prun
disease=dəˈziz
parenchymal=pəˈrɛŋkəm(ə)l
hypoplastic=hʌɪpəʊˈplastɪk
fraternal=frəˈtərn(ə)l
viral=ˈvaɪrəl
gangrene=ˈɡæŋˌɡrin
subfalcial=ˌsəbˈfælʃ(ə)l
tympanism=ˈtɪmpənɪz(ə)m
non-market=nɑnˈmɑrkət
postviral=ˌpoʊs(t)ˈvaɪrəl
lead=lid
coraco-acromial=ˌkɔrəkoʊəˈkroʊmiəl
amyloidosis=ˌæmɪlɔɪˈdəʊsɪs
feline=ˈfiˌlaɪn
disseminate=dəˈsɛməˌneɪt
hyaline=ˈhaɪələn
trimester=ˌtraɪˈmɛstər
phaeochromocytoma=ˌfeɪoʊˌkroʊməˌsaɪˈtoʊmə
retrosternal=ˌrɛtroʊˈstərn(ə)l
mucocele=ˈmjukoʊˌsil
pyogenic=ˌpaɪoʊˈdʒɛnɪk
access=ˈækˌsɛs
rheumatoid=ˈruməˌtɔɪd
worker=ˈwərkər
subglottic=ˌsəbˈɡlɑdɪk
oesophageal=əˌsɑfəˈdʒiəl
organize=ˈɔrɡəˌnaɪz
vestibular=vəˈstɪbjələr
suprasellar=ˌsuprəˈsɛlər
trachea=ˈtreɪkiə
misguide=ˌmɪsˈɡaɪd
multicystic=ˌməltiˈsɪstɪk
telephone=ˈtɛləˌfoʊn
vidian=ˈvɪdɪən
calycinal=kaˈlɪsɪnəl
fusiform=ˈfjuzəˌfɔrm
angioma=ˌændʒiˈoʊmə
decibel=ˈdɛsəb(ə)l
submandibular=ˌsəbˌmænˈdɪbjələr
lactational=lakˈteɪʃənəl
cartography=kɑrˈtɑɡrəfi
cluster=ˈkləstər
arachnoid=əˈrækˌnɔɪd
meningitis=ˌmɛnənˈdʒaɪdᵻs
intrazonal=ɪntrəˈzəʊnəl
artery=ˈɑrdəri
bleb=blɛb
case=keɪs
aid=eɪd
steeple=ˈstiːp(ə)l
tonsillar=ˈtɒnsɪlə
dandy=ˈdændi
beam=bim
dialysis=daɪˈæləsəs
neuropathic=ˌn(j)ʊrəˈpæθɪk
alpaca=ælˈpækə
cush=kʊʃ
enchondroma=ɛnkɒnˈdrəʊma
anareta=əˈnɛrədə
fibro-muscular=ˌfaɪbroʊˈməskjələr
rachitic=rəˈkɪdɪk
paraganglioma=ˌpɛrəˌɡæŋɡliˈoʊmə
thoracic=θəˈræsɪk
ureteral=jʊˈridərəl
pericardial=ˌpɛrəˈkɑrdiəl
kinetic=kəˈnɛdɪk
lymphoproliferative=ˌlɪmfoʊprəˈlɪfərədɪv
measurement=ˈmɛʒərm(ə)nt
popliteal=pɑpˈlɪdiəl
absence=ˈæbsən(t)s
endocrine=ˈɛndəkrən
shoulder=ˈʃoʊldər
without=wəˈðaʊt
fibro-adenoma=ˌfaɪbroʊˌædəˈnoʊmə
technetium=tɛkˈniʃ(i)əm
sinusitis=sʌɪnəˈsʌɪtɪs
patent=ˈpætnt
abdominal=æbˈdɑmən(ə)l
alveolar=ælˈvi(ə)lər
ultrasound=ˈəltrəˌsaʊnd
effect=əˈfɛk(t)
volvulus=ˈvɒlvjʊləs
mullerian=ˌm(j)ʊˈlɪriən
anchylose=ˈæŋkɪləʊz
polyp=ˈpɑləp
raynaud=ˈreɪnoʊ
nodule=ˈnɑdʒul
adenocarcinoma=ˌædn̩oʊˌkɑrsəˈnoʊmə
motion=ˈmoʊʃən
claw=klɔ
strawberry=ˈstrɔˌbɛri
occult=əˈkəlt
over-vain=ˌoʊvərˈveɪn
arteritis=ˌɑrdəˈraɪdᵻs
parovarian=ˌpɛroʊˈvɛriən
neonatal=ˌnioʊˈneɪdl
lexicon=ˈlɛksəˌkɑn
first=fərst
smoke=smoʊk
achalasia=ˌeɪkəˈleɪʒ(i)ə
turf=tərf
tombstone=ˈtumˌstoʊn
sling=slɪŋ
pneumoconiosis=ˌn(j)umoʊˌkoʊniˈoʊsəs
non-specific=ˌnɑnspəˈsɪfɪk
grid=ɡrɪd
disa=ˈdʌɪsə
burst=bərst
toe=toʊ
teratoid=ˈtɛrətɔɪd
erosive=ɪˈrəʊsɪv
bromelia=brəʊˈmiːlɪə
lobster=ˈlɑbstər
decrease=dəˈkris
neoplastic=ˌnioʊˈplæstɪk
banjara=bænˈdʒɑrə
recessive=rəˈsɛsɪv
extremity=ɪkˈstrɛmədi
epigastric=ɛpɪˈɡastrɪk
diethyl=dʌɪˈɛθɪl
velocity=vəˈlɑsədi
clavus=ˈkleɪvəs
septate=ˈsɛpˌteɪt
golden=ˈɡoʊldən
utricle=ˈjutrək(ə)l
lymphangioma=ˌlɪmfandʒɪˈəʊma
ilio=ˌɪlioʊˈləmˌbɑr
peripheral=pəˈrɪf(ə)rəl
indication=ˌɪndəˈkeɪʃən
nephrogram=ˈnɛfroʊˌɡræm
foramen=fəˈreɪmən
halo=ˈheɪloʊ
index=ˈɪnˌdɛks
fibroma=faɪˈbroʊmə
vascularity=ˌvæskjəˈlɛrədi
paralysis=pəˈræləsəs
random=ˈrændəm
skier=ˈskiər
parotid=pəˈrɑdəd
meckel=ˈmɛk(ə)l
complication=ˌkɑmpləˈkeɪʃən
dominance=ˈdɑmənən(t)s
uptake=ˌəpˈteɪk
histoplasmin=ˌhɪstoʊˈplæzmən
leukoplakial=ˌlukoʊˈpleɪkiəl
ovarian=oʊˈvɛriən
gliomatosis=ˌɡlʌɪəʊməˈtəʊsɪs
apical=ˈæpək(ə)l
lipoma=ləˈpoʊmə
necrotizing=ˈnɛkrəˌtaɪzɪŋ
consolidation=kənˌsɑləˈdeɪʃən
detector=dəˈtɛktər
disorder=dɪsˈɔrdər
osteoid=ˈɑstiˌɔɪd
neurofibroma=ˌn(j)ʊroʊˌfaɪˈbroʊmə
steatosis=stiːəˈtəʊsɪs
rathke=ˈrɑtkə
down=daʊn
hip=hɪp
bicepses=ˈbaɪˌsɛpsəz
limit=ˈlɪmᵻt
granuloma=ˌɡrænjəˈloʊmə
pyloric=paɪˈlɔrɪk
glabrate=ˈɡleɪbrət
frontal=ˈfrən(t)l
osteodystrophy=ˌɑstioʊˈdɪstrəfi
intra-abdominal=ˌɪntrəəbˈdɑmən(ə)l
bicornute=ˌbʌɪkɔːˈnjuːt
ochronosis=ˌoʊkrəˈnoʊsəs
accordion=əˈkɔrdiən
rosenthal=ˈroʊzənˌθɔl
slap=slæp
septic=ˈsɛptɪk
exercise=ˈɛksərˌsaɪz
anastomosis=əˌnæstəˈməʊsɪs
injection=ᵻnˈdʒɛkʃən
minus=ˈmaɪnəs
mediastinum=ˌmidiəˈstaɪnəm
intermediate=ˌɪn(t)ərˈmidiət
pentalogy=pɛnˈtælədʒi
astrocytoma=ˌæstrəˌsaɪˈtoʊmə
interatrial=ˌɪn(t)ərˈeɪtriəl
papilloma=ˌpæpəˈloʊmə
papillary=ˈpæpəˌlɛri
hapax=ˈhæpæks
meningioma=məˌnɪn(d)ʒiˈoʊmə
crescent=ˈkrɛs(ə)nt
junction=ˈdʒəŋ(k)ʃən
impingement=ɪmˈpɪndʒmənt
systolic=səˈstɑlɪk
dislocation=ˌdɪsloʊˈkeɪʃən
deficiency=dəˈfɪʃən(t)si
anus=ˈeɪnəs
ovary=ˈoʊv(ə)ri
web=wɛb
morgagni=mɔrˈɡɑni
achilles=əˈkɪliz
vascular=ˈvæskjələr
embryo=ˈɛmbriˌoʊ
boop=bup
giant=ˈdʒaɪənt
arterial=ɑrˈtɪriəl
paget=ˈpædʒət
uncalm=ˌənˈkɑ(l)m
man=mæn
scrotum=ˈskroʊdəm
overlie=ˌoʊvərˈlaɪ
bore=bɔr
hydrosalpinx=ˌhaɪdroʊˈsælˌpɪŋ(k)s
groove=ɡruv
carcinoid=ˈkɑrsəˌnɔɪd
obesity=oʊˈbisᵻdi
right=raɪt
ground=ɡraʊnd
apices=ˈeɪpəˌsiz
dresser=ˈdrɛsər
public=ˈpəblɪk
imperfect=ᵻmˈpərfək(t)
probit=ˈprɑbət
formation=fɔrˈmeɪʃən
pyrophosphate=ˌpaɪroʊˈfɑsˌfeɪt
newborn=ˈn(j)uˌbɔrn
type=taɪp
spectroscopy=spɛkˈtrɑskəpi
innominate=ɪˈnɒmɪnət
hypothyroidism=ˌhaɪpoʊˈθaɪˌrɔɪˌdɪzəm
haemophilic=hiːmə(ʊ)ˈfɪlɪk
spleen=splin
nasi=ˈnɑsi
pneumomediastinum=ˌn(j)umoʊˌmidiəˈstaɪnəm
haematogenous=ˌhiməˈtɑdʒənəs
metanephric=ˌmɛdəˈnɛfrɪk
see=si
intertrochanteric=ˌɪn(t)ərˌtroʊkænˈtɛrɪk
pineal=ˈpaɪniəl
cerebric=səˈrɛbrɪk
angioplasty=ˈændʒiəˌplæsti
misty=ˈmɪsti
pad=pæd
discotic=dɪˈskɑdɪk
hunter=ˈhən(t)ər
fossa=ˈfɔsə
seest=ˈsiᵻst
plasmacytoma=ˌplæzməˌsaɪˈtoʊmə
pie=paɪ
generator=ˈdʒɛnəˌreɪdər
wrist=rɪst
catheter=ˈkæθədər
ventral=ˈvɛntrəl
elbow=ˈɛlˌboʊ
xenon=ˈziˌnɑn
duplex=ˈd(j)uˌplɛks
stipple=ˈstɪp(ə)l
hypoxic=haɪˈpɑksɪk
schatz=ʃats
nuchal=ˈn(j)uk(ə)l
polyhydramnios=ˌpɑliˌhaɪˈdræmniəs
emphysema=ˌɛmfəˈsimə
maculopathy=ˌmækjəˈlɑpəθi
stenosis=stəˈnoʊsəs
mineral=ˈmɪn(ə)r(ə)l
design=dəˈzaɪn
carcinomatosis=ˌkɑrsəˌnoʊməˈtoʊsəs
endocardial=ɛndəʊˈkɑːdɪəl
connective=kəˈnɛktɪv
lumiere=l(j)uːmiːɛː
suprascapular=ˌsuprəˈskæpjələr
notochordal=ˌnoʊdəˈkɔrd(ə)l
plateau=plæˈtoʊ
rule=rul
clinical=ˈklɪnək(ə)l
thrombotic=ˌθrɑmˈbɑdɪk
pilon=ˈpɪˌlɑn
haematoma=ˌhiməˈtoʊmə
ductus=ˈdʌktəs
lymphadenopathy=ˌlɪmfadɪˈnɒpəθi
medication=ˌmɛdəˈkeɪʃən
circumferential=səˌkʌmfəˈrɛnʃ(ɪ)əl
cholelithiasis=ˌkoʊləlᵻˈθaɪəsəs
acardiac=eɪˈkɑrdiˌæk
repetition=ˌrɛpəˈtɪʃən
schwannoma=ʃvaˈnəʊmə
condor=ˈkɑnˌdɔr
medusa=məˈd(j)uzə
polygastric=ˌpɑliˈɡæstrɪk
concha=ˈkɑŋkə
external=ɪkˈstərn(ə)l
great=ɡreɪt
digital=ˈdɪdʒᵻdl
complex=ˌkɑmˈplɛks
belly=ˈbɛli
oligodendrocyte=ˌɑləɡoʊˈdɛndrəˌsaɪt
mitral=ˈmaɪtr(ə)l
enfold=ɛnˈfəʊld
abnormality=ˌæbnərˈmælədi
parathyroid=ˌpɛrəˈθaɪˌrɔɪd
ejecta=ɪˈdʒɛktə
haematocele=ˈhiːmətəʊˌsiːl
orbital=ˈɔrbədl
leiomyosarcoma=ˌlaɪoʊˌmaɪoʊsɑrˈkoʊmə
transitional=trænˈzɪʃ(ə)nəl
cervix=ˈsərˌvɪks
calcification=ˌkælsəfəˈkeɪʃən
ligament=ˈlɪɡəmənt
hepatic=həˈpædɪk
maffucci=ˌmæˈfutʃi
rotator=ˈroʊˌteɪdər
hognose=ˈhɔɡˌnoʊz
hypoglycaemia=ˌhaɪpoʊˌɡlaɪˈsimiə
sound=saʊnd
galactocele=ɡəˈlæktəˌsil
saw=sɔ
mri=ˌɛmˌɑrˈaɪ
milwaukeean=mɪlˈwɑkiən
fort=fɔrt
scurvy=ˈskərvi
pyonephrosis=ˌpaɪoʊnəˈfroʊsəs
by-pass=ˈbaɪˌpæs
fetal=ˈfid(ə)l
grave=ɡreɪv
papillomatosis=ˌpæpəˌloʊməˈtoʊsəs
evaluation=əˌvæljʊˈeɪʃən
bursa=ˈbərsə
langerhans=ˈlæŋərˌhænz
bilateral=ˌbaɪˈlædərəl
page=peɪdʒ
protein=ˈproʊˌtin
digit=ˈdɪdʒᵻt
vitreous=ˈvɪtriəs
cholesterol=kəˈlɛstəˌrɔl
osteonecrosis=ˌɑstioʊnəˈkroʊsəs
anomaly=əˈnɑməli
thickness=ˈθɪknᵻs
joint=dʒɔɪnt
inner=ˈɪnər
ependyma=ɛˈpɛndɪmə
overview=ˈoʊvərˌvju
surfer=ˈsərfər
nodose=ˈnoʊˌdoʊs
tarsal=ˈtɑːsəl
gestation=dʒɛˈsteɪʃən
second=ˈsɛkənd
diameter=daɪˈæmədər
quality=ˈkwɔlədi
acoustic=əˈkustɪk
vagile=ˈvadʒʌɪl
lock=lɑk
and=æn(d)
stress=strɛs
subluxation=ˌsəbˌləkˈseɪʃən
walker=ˈwɔkər
murphy=ˈmərfi
cake=keɪk
output=ˈaʊtˌpʊt
dystrophy=ˈdɪstrəfi
gangliopathy=ˌɡæŋɡliˈɑpəθi
peak=pik
parasitic=ˌpɛrəˈsɪdɪk
acromegaly=ˌækroʊˈmɛɡəli
barthian=ˈbɑːtɪən
mix=mɪks
tube=t(j)ub
chronic=ˈkrɑnɪk
brachio-cephalic=ˌbrakɪəʊsiːˈfalɪk
laryngotracheobronchitis=ləˌrɪŋɡoʊˌtreɪkioʊˌbrɑŋˈkaɪdᵻs
cruciate=ˈkruʃ(i)ət
grape=ɡreɪp
romanes=ˈrɑməˌnɪs
croon=krun
triple=ˈtrɪp(ə)l
pathology=pəˈθɑlədʒi
seizure=ˈsiʒər
physiology=ˌfɪziˈɑlədʒi
encephalomyelitis=ᵻnˌsɛfəloʊˌmaɪəˈlaɪdᵻs
seen=sin
pleura=ˈplʊrə
extra-capsular=ˌɛkstrəˈkæps(j)ələr
fringe=frɪndʒ
osteomalacia=ˌɑstioʊməˈleɪʃ(i)ə
physis=ˈfaɪsəs
post-traumatic=ˌpoʊs(t)ˌtrɔˈmædɪk
under=ˈəndər
allergic=əˈlərdʒɪk
banana=bəˈnænə
sac=sæk
uterus=ˈjudərəs
hydatid=ˈhʌɪdətɪd
reflex=ˈriˌflɛks
hydrocephalus=ˌhaɪdroʊˈsɛfələs
biopsy=ˈbaɪˌɑpsi
behold=bəˈhoʊld
mesenteric=ˌmɛzənˈtɛrɪk
heller=ˈhɛlər
caustic=ˈkɔstɪk
avulsion=əˈvʌlʃən
hypertension=ˌhaɪpərˈtɛnʃən
rate=reɪt
dilate=daɪˈleɪt
foregut=ˈfɔrˌɡət
femoral=ˈfɛm(ə)rəl
metastasis=məˈtæstəsəs
asbestosis=azbɛˈstəʊsɪs
hangman=ˈhæŋmən
seeth=ˈsiᵻθ
coal=koʊl
focal=ˈfoʊkəl
retroperitoneum=ˌrɛtroʊˌpɛrətnˈiəm
rectal=ˈrɛkt(ə)l
autoimmune=ˌɔdoʊəˈmjun
myocarditis=ˌmaɪoʊˌkɑrˈdaɪdᵻs
primary=ˈpraɪˌmɛri
serositis=sɪərəʊˈsʌɪtɪs
pseudopseudohypoparathyroidism=ˌsudoʊˌsudoʊˌhaɪpoʊˌpɛrəˈθaɪˌrɔɪˌdɪzəm
brown=braʊn
fissure=ˈfɪʃər
thorax=ˈθɔˌræks
pelvic=ˈpɛlvɪk
cyclical=ˈsɪklək(ə)l
thyroglossal=ˌθaɪrəˈɡlɔs(ə)l
madelung=ˈmæd(ə)ˌləŋ
facet=ˈfæsət
enterocolitis=ˌɛn(t)əroʊkəˈlaɪdəs
amoebic=əˈmibɪk
fetus=ˈfidəs
vaso-constriction=ˌveɪzoʊkənˈstrɪkʃən
technical=ˈtɛknək(ə)l
ileo-colic=ˌɪlioʊˈkɑlɪk
adenoid=ˈædnˌɔɪd
annular=ˈænjələr
sponge=spəndʒ
degenerative=dəˈdʒɛnərədɪv
rickets=ˈrɪkᵻts
inflammation=ˌɪnfləˈmeɪʃən
spondylitis=ˌspɑndəˈlaɪdᵻs
rhabdomyoma=ˌræbdoʊˌmaɪˈoʊmə
pancreatitis=ˌpæŋkriəˈtaɪdᵻs
treatment=ˈtritmənt
bile=baɪl
mature=məˈtʃər
gland=ɡlænd
chauffeur=ˈʃoʊfər
rhombencephalon=ˌrɑmbənˈsɛfələn
champart=ˈʃɒmpɑː
jumper=ˈdʒəmpər
restrictive=rɪˈstrɪktɪv
idiopathic=ˌɪdiəˈpæθɪk
atrium=ˈeɪtriəm
obliterate=əˈblɪdəˌreɪt
wegener=ˈveɪɡənə
miliary=ˈmɪliˌɛri
barrier=ˈbɛriər
omental=oʊˈmɛn(t)l
accessory=əkˈsɛs(ə)ri
rugger=ˈrəɡər
herpes=ˈhərpiz
wili=ˈvɪli
glioblastoma=ɡlʌɪəʊblaˈstəʊmə
gauche=ɡoʊʃ
transmural=trɑːnzˈmjʊərəl
immune=ᵻˈmjun
cervical=ˈsərvɪkəl
microangiopathy=ˌmaɪkroʊˌændʒiˈɑpəθi
calcium=ˈkælsiəm
molar=ˈmoʊlər
test=tɛst
plus=pləs
microcyst=ˈmaɪkroʊˌsɪst
league=liɡ
encephalopathy=ᵻnˌsɛfəˈlɑpəθi
follicular=fəˈlɪkjələr
surgical=ˈsərdʒək(ə)l
desquamative=dɪˈskwamətɪv
fibrillary=ˈfʌɪbrɪləri
circle=ˈsərk(ə)l
chest=tʃɛst
accrete=əˈkrit
vipoma=vʌɪˈpəʊmə
enostosis=ɛnɒˈstəʊsɪs
large=lɑrdʒ
alkaptonuria=ælˌkæptəˈn(j)ʊriə
con=kɑn
hot-potato=ˌhɑt pəˈteɪdoʊ
contiguous=kənˈtɪɡjəwəs
specific=spəˈsɪfɪk
gamekeeper=ˈɡeɪmˌkipər
resolution=ˌrɛzəˈluʃən
extension=ɪkˈstɛn(t)ʃ(ə)n
sublabial=ˌsəbˈleɪbiəl
meconium=məˈkoʊniəm
intertype=ˈɪntətʌɪp
development=dəˈvɛləpmənt
bond=bɑnd
carolin=ˈkarəlɪn
articular=ɑrˈtɪkjələr
mucinous=ˈmjusənəs
host=hoʊst
cholangiography=kəˌlændʒiˈɑɡrəfi
weight=weɪt
endometrium=ˌɛndəˈmitriəm
pleural=ˈplʊrəl
involucrum=ɪnvəʊˈl(j)uːkrəm
bacterial=bækˈtɪriəl
capsulitis=kapsjuːˈlʌɪtɪs
involvement=ᵻnˈvɑlvmənt
nasal=ˈneɪz(ə)l
arc=ɑrk
tendinitis=tɛndɪˈnʌɪtɪs
cellulitis=ˌsɛljəˈlaɪdᵻs
intramedullary=ˌɪntrəməˈdəl(ə)ri
bigfoot=ˈbɪɡˌfʊt
lymph=lɪmf
polyposis=ˌpɑləˈpoʊsɪs
lymphoid=ˈlɪmˌfɔɪd
female=ˈfiˌmeɪl
necrosis=nəˈkroʊsəs
flair=flɛr
reassociate=ˌriəˈsoʊsiˌeɪt
trigeminal=traɪˈdʒɛmən(ə)l
spurge=spərdʒ
bridie=ˈbraɪdi
adamantinoma=ˌædəˌmæn(t)əˈnoʊmə
consideration=kənˌsɪdərˈeɪʃən
genitourinary=ˌdʒɛnədoʊˈjʊrəˌnɛri
pleomorphic=ˌpliəˈmɔrfɪk
at=æt
polycystic=ˌpɑliˈsɪstɪk
lacteal=ˈlæktiəl
procedure=prəˈsidʒər
paravertebral=ˌpɛrəˈvərdəbr(ə)l
tubular=ˈt(j)ubjələr
evulsion=ɪˈvʌlʃən
hepatitis=ˌhɛpəˈtaɪdᵻs
oxine=ˈɑkˌsin
aerophile=ˈɛroʊˌfaɪl
node=noʊd
main=meɪn
lunate=ˈluˌneɪt
placenta=pləˈsɛn(t)ə
empyema=ˌɛmpaɪˈimə
insufficiency=ˌɪnsəˈfɪʃənsi
lemon=ˈlɛmən
hydronephrosis=ˌhʌɪdrə(ʊ)nɪˈfrəʊsɪs
leucocyte=ˈlukəˌsaɪt
feed=fid
crystal=ˈkrɪstl
mycotic=maɪˈkɑdɪk
lupus=ˈlupəs
terry=ˈtɛri
amniotic=ˌæmniˈɑdɪk
defect=ˈdifɛk(t)
unicameral=ˌjunəˈkæm(ə)rəl
anchylosis=æŋkɪˈləʊsɪs
interlobular=ɪntəˈlɒbjʊlə
meniscal=məˈnɪsk(ə)l
meningocele=məˈnɪŋɡəˌsil
diffuse=dᵻˈfjus
morphology=mɔrˈfɑlədʒi
gastro-oesophageal=ˌɡæstroʊəˌsɑfəˈdʒiəl
marrow=ˈmɛroʊ
tetralogy=tɪˈtralədʒi
infarct=ˈɪnˌfɑrk(t)
mauthner=ˈmaʊθnər
increase=ᵻnˈkris
creutzfeldt-jakob=ˌkrɔɪtsfɛltˈjakɒb
bowel=ˈbaʊ(ə)l
trauma=ˈtrɔmə
opacification=oʊˌpæsəfəˈkeɪʃən
telangiectasis=tɪlandʒɪˈɛktəsɪs
parastatal=ˌpɛrəˈsteɪdl
cardiomyopathy=ˌkɑrdioʊˌmaɪˈɑpəθi
otosclerosis=ˌoʊdoʊskləˈroʊsəs
lady=ˈleɪdi
testicular=tɛˈstɪkjələr
simple=ˈsɪmpəl
thermal=ˈθərm(ə)l
blout=blaʊt
technique=tɛkˈnik
third=θərd
anderson=ˈændərs(ə)n
pulse=pəls
hypertrophy=haɪˈpərtrəfi
pia-arachnoid=ˌpaɪəəˈrækˌnɔɪd
bulla=ˈbʊlə
auteur=oʊˈtər
stricture=ˈstrɪk(t)ʃər
splenic=ˈsplinɪk
big-ass=ˈbɪɡˌæs
cancer=ˈkæn(t)sər
spherule=ˈsfɪˌrul
tuberous=ˈtjuːbərəs
caterpillar=ˈkædərˌpɪlər
gastrostomy=ɡaˈstrɒstəmi
mechanical=məˈkænək(ə)l
candidiasis=-ˈdaɪəsɪs
prerectal=ˌpriˈrɛkt(ə)l
low-grade=ˈloʊˌɡreɪd
ace=eɪs
foreign=ˈfɔrən
x-ray=ˈɛksˌreɪ
diverticular=ˌdaɪvərˈtɪkjələr
dysfunction=dɪsˈfəŋkʃən
steal=stil
boggard=ˈbɒɡəd
thumb=θəm
acetabular=ˌæsəˈtæbjələr
interpretation=ᵻnˌtərprəˈteɪʃən
interval=ˈɪn(t)ərv(ə)l
orientation=ˌɔriənˈteɪʃən
intact=ᵻnˈtæk(t)
caesarean=siːˈzɛːrɪən
globe=ɡloʊb
jaune=dʒɔːn
tim=tɪm
larynx=ˈlɛrɪŋks
carval=ˈkɑrv(ə)l
late=leɪt
renal=ˈrin(ə)l
cartilage=ˈkɑrdl̩ɪdʒ
distortion=dəˈstɔrʃən
thallium=ˈθæliəm
temporal=ˈtɛmp(ə)rəl
developmental=dəˌvɛləpˈmɛn(t)l
arterious=ɑrˈtɪriəs
ammonia=əˈməʊnɪə
borne=bɔrn
radiosensitivity=ˌreɪdioʊˌsɛn(t)səˈtɪvᵻdi
tc=ˌtiˈsi
pneumothorax=ˌn(j)umoʊˈθɔˌræks
speed=spid
extradural=ˌɛkstrəˈd(j)ʊrəl
system=ˈsɪstəm
floor=flɔr
cryptococcus=ˌkrɪptəˈkɑkəs
inflammatory=ᵻnˈflæməˌtɔri
toddler=ˈtɑd(ə)lər
median=ˈmidiən
solve=sɑlv
supracondylar=ˌsuprəˈkɑndələr
nutcracker=ˈnətˌkrækər
silicone=ˈsɪləˌkoʊn
haemorrhagic=ˌhɛməˈrædʒɪk
multiple=ˈməltəp(ə)l
oreo=ˈɔrioʊ
salter=ˈsɔltər
intrahepatic=ˌɪntrəhəˈpædɪk
infectious=ᵻnˈfɛkʃəs
airway=ˈɛrˌweɪ
eternalism=əˈtərnəˌlɪzəm
intensity=ᵻnˈtɛn(t)sədi
tail=teɪl
activity=ækˈtɪvᵻdi
gall-bladder=ˈɡɔːl ˌbladə
deterministic=dəˌtərməˈnɪstɪk
osteochondroma=ˌɑstioʊˌkɑnˈdroʊmə
atherosclerotic=ˌæθəˌroʊskləˈrɑdɪk
haver=ˈhævər
heartbeat=ˈhɑrtˌbit
sacro-iliac=ˌseɪkroʊˈɪliˌæk
line=laɪn
varicocele=ˈvɛrəkoʊˌsil
presentation=ˌprɛznˈteɪʃən
hilum=ˈhaɪləm
neo-norman=ˌnioʊˈnɔrm(ə)n
hilar=ˈhʌɪlə
stone=stoʊn
bucket=ˈbəkət
neuroendocrine=ˌn(j)ʊroʊˈɛndəkr(ə)n
endocarditis=ˌɛndoʊˌkɑrˈdaɪdᵻs
talus=ˈteɪləs
nodular=ˈnɑdʒələr
interfacial=ˌɪn(t)ərˈfeɪʃ(ə)l
endobronchial=ˌɛndoʊˈbrɑŋkiəl
thanatophoric=ˌθænədəˈfɔrɪk
in=ɪn
cloaca=kloʊˈeɪkə
abscess=ˈæbˌsɛs
chemotherapy=ˌkimoʊˈθɛrəpi
nephrolithiasis=ˌnɛfroʊləˈθaɪəsəs
multiform=ˈməltiˌfɔrm
supermuscan=ˌsupərˈməsk(ə)n
glomus=ˈɡləʊməs
couvert=kuːˈvɛː
osteogenesis=ˌɑstioʊˈdʒɛnəsəs
postoperative=ˌpoʊsˈtɑp(ə)rədɪv
oblique=əˈblik
intraracial=ˌɪntrəˈreɪʃ(ə)l
embolism=ˈɛmbəˌlɪzəm
epithelial=ˌɛpəˈθiliəl
sella=ˈsɛlə
media=ˈmidiə
circumflex=ˈsərkəmˌflɛks
prolong=prəˈlɔŋ
thicken=ˈθɪkən
prematurity=ˌpriməˈtʃərədi
ratio=ˈreɪʃ(i)oʊ
percutaneous=ˌpərkjuˈteɪniəs
osteoblastoma=ˌɑstioʊˌblæˈstoʊmə
corduroy=ˈkɔːdərɔɪ
reaction=riˈækʃən
charge=tʃɑrdʒ
endotracheal=ˌɛndəˈtreɪkiəl
distal=ˈdɪst(ə)l
osteosarcoma=ˌɑstioʊˌsɑrˈkoʊmə
versus=ˈvərsəs
subdural=ˌsəbˈd(j)ʊrəl
fibrosis=faɪˈbroʊsəs
superior=səˈpɪriər
whipple=ˈhwɪp(ə)l
caput=ˈkapʌt
fundic=ˈfəndɪk
an=æn
nuclear=ˈn(j)ukliər
derma=ˈdərmə
hypoparathyroidism=ˌhaɪpoʊˌpɛrəˈθaɪrɔɪˌdɪzəm
paraspinal=ˌpɛrəˈspaɪn(ə)l
hammer=ˈhæmər
cord=kɔrd
outlet=ˈaʊtˌlɛt
right-sided=ˌraɪtˈsaɪdᵻd
endometrial=ˌɛndəˈmitriəl
ascend=əˈsɛnd
riojan=riˈoʊ(h)ən
sublingual=ˌsəbˈlɪŋɡw(ə)l
sprue=spru
cardiomegaly=ˌkɑrdioʊˈmɛɡəli
shiny=ˈʃaɪni
structural=ˈstrək(t)ʃ(ə)rəl
localization=ˌloʊkələˈzeɪʃən
jaundice=ˈdʒɔndəs
gout=ɡaʊt
interaction=ˌɪn(t)əˈrækʃən
mesenteritis=ˌmɛzən(t)əˈraɪdᵻs
harris=ˈhɛrəs
atypical=ˌeɪˈtɪpᵻk(ə)l
anencephaly=ˌænˌɛnˈsɛfəli
rhabdoid=ˈræbdɔɪd
metformin=mɛtˈfɔrmɪn
troland=ˈtrəʊlənd
mutilate=ˈmjudlˌeɪt
telescope=ˈtɛləˌskoʊp
nerve=nərv
periventricular=ˌpɛrəˌvɛnˈtrɪkjələr
achondroplasia=ˌeɪˌkɑndrəˈpleɪʒ(i)ə
peritoneum=ˌpɛrətnˈiəm
problem=ˈprɑbləm
layer=ˈleɪər
spine=spaɪn
aplasia=əˈpleɪʒiə
acromio-clavicular=əˌkroʊmioʊkləˈvɪkjələr
gallium=ˈɡæliəm
pyosalpinx=ˌpaɪoʊˈsælˌpɪŋ(k)s
double=ˈdəb(ə)l
grade=ɡreɪd
crook=krʊk
management=ˈmænɪdʒmənt
teardrop=ˈtɪrˌdrɑp
medullary=məˈdəl(ə)ri
uterine=ˈjudərən
mammoplasty=ˈmæməˌplæsti
application=ˌæpləˈkeɪʃən
child=tʃaɪld
oncotic=ɑnˈkɑdɪk
extensor=ɪkˈstɛnsər
umbilical=ˌəmˈbɪlək(ə)l
fungal=ˈfəŋɡ(ə)l
acinar=ˈæsənər
origin=ˈɔrədʒ(ə)n
adenosine=əˈdɛnəˌsin
psoriatic=ˌsɔriˈædɪk
ampliate=ˈæmpliˌeɪt
portal=ˈpɔrdl
atherosclerosis=ˌæθəˌroʊskləˈroʊsəs
methanol=ˈmɛθəˌnɔl
whole=hoʊl
de=di
avascular=əˈvaskjʊlə
beta=ˈbeɪdə
pave=peɪv
dish=dɪʃ
workup=ˈwərkˌəp
cerebellum=ˌsɛrəˈbɛləm
cattleman=ˈkædlmən
nodal=ˈnoʊd(ə)l
malignant=məˈlɪɡnənt
herniation=həːnɪˈeɪʃən
systemic=səˈstɛmɪk
thymoma=ˈθʌɪməʊmə
malrotation=ˌmælroʊˈteɪʃən
endometriosis=ˌɛndəˌmitriˈoʊsəs
death=dɛθ
medial=ˈmidiəl
thomas=ˈtɑməs
wohler=ˈvəːlə
salivary=ˈsæləˌvɛri
aspiration=ˌæspəˈreɪʃən
gastro-intestinal=ˌɡæstroʊᵻnˈtɛstən(ə)l
proxeny=ˈprɑksəni
hypotension=ˌhaɪpəˈtɛn(t)ʃən
traumatic=trɔˈmædɪk
panencephalitis=ˌpænənˌsɛfəˈlaɪdəs
metastatic=ˌmɛdəˈstædɪk
thymus=ˈθaɪməs
voice=vɔɪs
respiratory=ˈrɛsp(ə)rəˌtɔri
scimitar=ˈsɪmədər
radiologic=ˌreɪdiəˈlɑdʒɪk
length=lɛŋ(k)θ
intraventricular=ɪntrəvɛnˈtrɪkjʊlə
pterygopalatine=ˌtɛrəɡoʊˈpæləˌtaɪn
germ=dʒərm
contrast=ˈkɑnˌtræst
general=ˈdʒɛn(ə)rəl
exudative=ɛkˈsjuːdətɪv
freeze=friz
neck=nɛk
commere=ˈkɒmɛː
cortex=ˈkɔrˌtɛks
occupational=ˌɑkjəˈpeɪʃən(ə)l
ventricular=vɛnˈtrɪkjələr
liposarcoma=ˌlɪpoʊˌsɑrˈkoʊmə
dose=doʊs
airsick=ˈɛrˌsɪk
hydrops=ˈhʌɪdrɒps
mesoblastic=ˌmɛzoʊˈblæstɪk
contusion=kənˈtuʒən
energy=ˈɛnərdʒi
fifth=fɪ(f)θ
unilateral=ˌjunəˈlædərəl
half-value=ˌhæfˈvælju
enlargement=ᵻnˈlɑrdʒmənt
coloboma=kɒləʊˈbəʊmə
abruption=əˈbrəpʃən
cryptogenic=ˌkrɪptəˈdʒɛnɪk
microcolony=ˈmaɪkroʊˌkɑləni
haemangioblastoma=hiːˌmandʒɪəʊblaˈstəʊmə
sequestrum=sɪˈkwɛstrəm
preparation=ˌprɛpəˈreɪʃən
subacute=ˌsəbəˈkjut
demyelination=diːˌmʌɪəlɪˈneɪʃən
subarachnoid=ˌsəbəˈrækˌnɔɪd
sees=siz
ulcer=ˈəlsər
captain=ˈkæpt(ə)n
lymphoma=lɪmˈfoʊmə
point=pɔɪnt
galen=ˈɡeɪlən
injury=ˈɪndʒ(ə)ri
bridge=brɪdʒ
association=əˌsoʊsiˈeɪʃən
entry=ˈɛntri
percheron=ˈpɛr(t)ʃəˌrɑn
section=ˈsɛkʃən
scale=skeɪl
prion=ˈpriˌɑn
angiography=ˌændʒiˈɑɡrəfi
ewe=ju
proteinosis=ˌproʊˌtiˈnoʊsəs
sulcus=ˈsəlkəs
puff=pəf
field=fild
mediastinal=ˌmidiəˈstaɪn(ə)l
glandular=ˈɡlændʒələr
juvenile=ˈdʒuvəˌnaɪl
heel=hil
fracture=ˈfræktʃər
knee=ni
multiplex=ˈməltiˌplɛks
translucency=trænzˈlusən(t)si
change=tʃeɪndʒ
hypopharynx=ˈhʌɪpə(ʊ)farɪŋks
assessment=əˈsɛsmənt
patella=pəˈtɛlə
skeletal=ˈskɛləd(ə)l
metatarsal=ˈmɛdəˌtɑrs(ə)l
drummond=ˈdrəmənd
role=roʊl
colic=ˈkɑlɪk
osteomyelitis=ˌɑstɪoʊˌmaɪ(ə)ˈlaɪdᵻs
extravasation=ɛkˌstravəˈseɪʃən
fold=foʊld
cytomegalovirus=ˌsaɪdəˈmɛɡ(ə)loʊˌvaɪrəs
emergency=əˈmərdʒən(t)si
cerebrovascular=ˌsɛrɪbrəʊˈvaskjʊlə
valvular=ˈvælvjələr
territory=ˈtɛrəˌtɔri
tip=tɪp
arteriovenous=ɑrˌtɪrioʊˈvinəs
teno-synovitis=ˌtɛnoʊˌsɪnəˈvaɪdᵻs
imperforate=ᵻmˈpərfərət
gleno=ˌɡlɛnoʊˈ(h)jumərəl
density=ˈdɛn(t)sədi
meniscus=məˈnɪskəs
bugler=ˈbjuɡlər
sjogren=ˈʃəːɡrən
magic=ˈmædʒɪk
diffusion=dᵻˈfjuʒən
lyme=ˈlʌɪm
histologic=ˌhɪstəˈlɑdʒɪk
anterior=ænˈtɪriər
dizygotic=dʌɪzʌɪˈɡɒtɪk
cell=sɛl
chorionic=kɔːrɪˈɒnɪk
anatomy=əˈnætəmɪ
testis=ˈtɛstəs
oil=ɔɪl
stromal=ˈstrəʊməl
venous=ˈvinəs
unit=ˈjunət
thyroid=ˈθaɪˌrɔɪd
albicant=ˈælbək(ə)nt
hypertrophic=hʌɪpəˈtrɒfɪk
born=bɔrn
renogram=ˈrinəˌɡræm
hyperthyroidism=ˌhaɪpərˈθaɪˌrɔɪˌdɪzəm
penetrate=ˈpɛnəˌtreɪt
fisher=ˈfɪʃər
tracheitis=treɪkiːˈʌɪtɪs
manifestation=ˌmænəfəˈsteɪʃən
albumin=ælˈbjumən
diagnostic=ˌdaɪəɡˈnɑstɪk
fasciitis=faʃɪˈʌɪtɪs
ai=ˈɑˌi
film=fɪlm
collateral=kəˈlædərəl
hypoplasia=ˌhaɪpəˈpleɪʒ(i)ə
deposition=ˌdɛpəˈzɪʃən
ectasia=ɛkˈteɪzɪə
capillary=ˈkæpəˌlɛri
deformity=dəˈfɔrmədi
sarcoidosis=sɑːkɔɪˈdəʊsɪs
flat=flæt
baffler=ˈbæf(ə)lər
focus=ˈfoʊkəs
ventricle=ˈvɛntrək(ə)l
atelectasis=atɪˈlɛktəsɪs
rest=rɛst
transverse=ˌtrænzˈvərs
perifusate=ˌpɛrəˈfjuzeɪt
cardiac=ˈkɑrdiˌæk
vasospasm=ˈveɪzoʊˌspæzəm
retropharyngeal=ˌrɛtroʊfəˈrɪndʒ(i)əl
vertebral=ˈvərdəbrəl
photoelectric=ˌfoʊdoʊəˈlɛktrɪk
slip=slɪp
white=(h)waɪt
sacro-iliitis=ˌseɪkroʊˌɪliˈaɪdᵻs
paroemia=pəˈrimiə
motility=moʊˈtɪlᵻdi
cacogenic=kakəʊˈdʒɛnɪk
medic=ˈmɛdɪk
intramammary=ˌɪntrəˈmæm(ə)ri
appearance=əˈpɪrən(t)s
vitamin=ˈvaɪdəmən
intraductal=ˌɪntrəˈdəkt(ə)l
ascites=əˈsaɪdiz
boxer=ˈbɑksər
angiosarcoma=ˌændʒioʊˌsɑrˈkoʊmə
tennis=ˈtɛnəs
bronchogenic=ˌbrɑŋkəˈdʒɛnɪk
interstitial=ˌɪn(t)ərˈstɪʃ(ə)l
persistent=pərˈsɪstənt
medulla=məˈdələ
average=ˈæv(ə)rɪdʒ
recurrence=rəˈkərən(t)s
truncus=ˈtrʌŋkəs
septal=ˈsɛpt(ə)l
by=baɪ
synostosis=sɪnɒˈstəʊsɪs
boutonniere=buːtɒnˈjɛː
biology=baɪˈɑlədʒi
aneurysmal=ˌænjəˈrɪzm(ə)l
tract=træk(t)
effective=əˈfɛktɪv
sialolithiasis=ˌsaɪəloʊləˈθaɪəsəs
leg=lɛɡ
tendon=ˈtɛndən
jelly=ˈdʒɛli
health=hɛlθ
bladder=ˈblædər
horizontal=ˌhɔrəˈzɑn(t)l
radionuclide=ˌreɪdioʊˈn(j)uˌklaɪd
echinococcus=əˌkaɪnəˈkɑkəs
teratoma=tɛrəˈtəʊmə
sever=ˈsɛvər
lucency=ˈlus(ə)n(t)si
retention=rəˈtɛnʃən
jugulate=ˈdʒəɡjəˌleɪt
intratesticular=ˌɪntrəˌtɛˈstɪkjələr
atresia=əˈtriʒ(i)ə
stochastic=stəˈkæstɪk
haemoptysis=hiːˈmɒptɪsɪs
Cryptococci=ˌkrɪptəˈkɑˌkaɪ
elevational=ɛlɪˈveɪʃənəl
fascial=ˈfæʃ(i)əl
quadriceps=ˈkwɑdrəˌsɛps
invasive=ᵻnˈveɪsɪv
tricuspid=traɪˈkəspəd
atrial=ˈeɪtriəl
hurler=ˈhəːlə
epiphysis=ɛˈpɪfɪsɪs
enteritis=ˌɛn(t)əˈraɪdᵻs
sail=seɪl
cushion=ˈkʊʃən
bilious=ˈbɪliəs
osteoarthritis=ˌɑstioʊˌɑrˈθraɪdᵻs
optical=ˈɑptək(ə)l
oedema=əˈdimə
coccidiosis=ˌkɑkˌsɪdiˈoʊsəs
hiv=ˌeɪtʃˌaɪˈvi
carotic=kəˈrɒtɪk
bone=boʊn
receiver=rəˈsivər
mole=moʊl
inversion=ᵻnˈvərʒ(ə)n
support=səˈpɔrt
fatty=ˈfædi
tibial=ˈtɪbiəl
syphilides=ˌsɪˈfɪlədiz
cyanotic=sʌɪəˈnɒtɪk
sympathetic=ˌsɪmpəˈθɛdɪk
vertical=ˈvərdək(ə)l
portosystemic=ˌpɔrdoʊsəˈstɛmɪk
jejunal=dʒiːˈdʒuːnəl
intestinal=ᵻnˈtɛstən(ə)l
aortic=eɪˈɔrdɪk
individual=ˌɪndəˈvɪdʒ(ə)wəl
enchondromatous=ɛnkɒnˈdrəʊmətəs
apophysial=apəʊˈfɪzɪəl
rim=rɪm
progressive=prəˈɡrɛsɪv
choroid=ˈkɔrɔɪd
marburg=ˈmɑrˌbərɡ
aq=eɪk
with=wɪð
germinal=ˈdʒərmənəl
sphenoid=ˈsfiˌnɔɪd
coalition=ˌkoʊəˈlɪʃən
empty=ˈɛm(p)ti
near=nɪ(ə)r
post-primary=ˌpoʊs(t)ˈpraɪˌmɛri
fibrous=ˈfaɪbrəs
eye=aɪ
histiocytosis=ˌhɪstiəˌsaɪˈtoʊsəs
dehydrate=diːˈhʌɪdreɪt
cause=kɔz
diaphragmatic=ˌdʌɪəfraɡˈmatɪk
popcorn=ˈpɑpˌkɔrn
carotid=kəˈrɑdəd
collect=kəˈlɛk(t)
tillage=ˈtɪlɪdʒ
probability=ˌprɑbəˈbɪlᵻdi
mediae=ˈmidiˌi
differential=ˌdɪfəˈrɛn(t)ʃ(ə)l
appendicitides=əˌpɛndəˈsaɪtᵻˌdiz
patient=ˈpeɪʃənt
excreta=ɛkˈskridə
peridental=ˌpɛrəˈdɛn(t)l
adhesive=ædˈ(h)izɪv
hypophysics=ˌhaɪpəˈfɪzɪks
slide-wire=ˈslaɪdˌwaɪ(ə)r
radiotracer=ˈreɪdioʊˌtreɪsər
stroke=stroʊk
mastocytosis=ˌmæstəˌsɑɪˈtoʊsəs
neurofibromatosis=ˌn(j)ʊroʊˌfaɪbroʊməˈtoʊsəs
effusion=əˈfjuʒən
synovitis=ˌsɪnəˈvaɪdᵻs
femora=ˈfɛmərə
abstain=əbˈsteɪn
cyst=sɪst
axial=ˈæksiəl
cardiology=ˌkɑrdiˈɑlədʒi
gallstone=ˈɡɔlˌstoʊn
peritonitis=ˌpɛrətnˈaɪdᵻs
paranasal=ˌpɛrəˈneɪz(ə)l
instability=ˌɪn(t)stəˈbɪlᵻdi
enhancement=ᵻnˈhæn(t)smənt
vein=veɪn
shunt=ʃənt
scapho-lunar=ˌskæfoʊˈlunər
haemorrhage=ˈhɛm(ə)rɪdʒ
varix=ˈvɛrɪks
lamina=ˈlæmənə
grey=ɡreɪ
oesophagitis=əˌsɑfəˈdʒaɪdᵻs
neuroblastoma=ˌn(j)ʊroʊˌblæˈstoʊmə
wander=ˈwɑndər
damson=ˈdamz(ə)n
sialadenitis=ˌsaɪəlˌædnˈaɪdᵻs
spiculated=ˈspɪkjəˌleɪdᵻd
resistive=rəˈzɪstɪv
spermatocele=ˈspəːmətə(ʊ)siːl
pet=pɛt
epididymal=ɛpɪˈdɪdɪməl
insertion=ᵻnˈsərʃən
dysplasia=dɪsˈpleɪʒ(i)ə
limburger=ˈlɪmˌbərɡər
curve=kərv
oligohydramnios=ˌɑləɡoʊˌhaɪˈdræmniˌɑs
glass=ɡlæs
balthazar=bælˈθæzər
pearl=pərl
fovea=ˈfoʊviə
anatomic=ænəˈtɒmɪk
div=diːv
plexiform=ˈplɛksəˌfɔrm
keratin=ˈkɛrətn
iggri=ˈɪɡri
conductive=kənˈdəktɪv
hepatocystic=ˌhɛpədoʊˈsɪstɪk
ethmoidal=ˌɛθˈmɔɪd(ə)l
malt=mɔlt
portion=ˈpɔrʃən
periapical=ˌpɛriˈæpək(ə)l
epicanthus=ˌɛpəˈkænθəs
fibre=ˈfaɪbər
remnant=ˈrɛmnənt
hyaloid=ˈhaɪəˌlɔɪd
hypotympanic=ˌhaɪpoʊˌtɪmˈpænɪk
dacryo=ˌdækrioʊsᵻˈstaɪdᵻs
brachial=ˈbreɪkiəl
sphenooccipital=ˌsfinoʊˌɑkˈsɪpᵻd(ə)l
palpebra=ˈpælpəbrə
mesotympanic=ˌmɛzoʊˌtɪmˈpænɪk
motor=ˈmoʊdər
cave=keɪv
deficit=ˈdɛfəsət
stapedial=stəˈpiːdɪəl
genetics=dʒəˈnɛdɪks
usually=ˈfeɪʃ(i)ə
rubber=ˈrəbər
encephalocele=ɛnˈsɛfələʊˌsiːl
glossopteris=ɡlɒˈsɒptərɪs
secondary=ˈsɛkənˌdɛri
dental=ˈdɛn(t)l
mandibular=mænˈdɪbjələr
platysma=pləˈtɪzmə
fay=feɪ
selective=səˈlɛktɪv
calvaria=kælˈvɛriəm
tinnitus=ˈtɪnədəs
distant=ˈdɪst(ə)nt
high-riding=ˌhaɪˈraɪdɪŋ
daff=dɑːf
suprahyoid=ˌsuprəˈhaɪˌɔɪd
torus=ˈtɔrəs
gardner=ˈɡɑrdnər
chamber=ˈtʃeɪmbər
meatus=miˈeɪdəs
dyskinesia=ˌdɪskᵻˈniziə
trochlear=ˈtrɒkliːə
maxillary=ˈmæksəˌlɛri
vagal=ˈveɪɡ(ə)l
vagus=ˈveɪɡəs
prominent=ˈprɑmən(ə)nt
thyro-epiglottic=ˌθaɪroʊˌɛpəˈɡlɑdɪk
subarcuate=ˌsəbˈɑrkjəwət
tej=tɛdʒ
non-modal=ˌnɑnˈmoʊd(ə)l
myxomata=mɪkˈsoʊmədə
subside=səbˈsaɪd
graphic=ˈɡræfɪk
gully=ˈɡəli
jaw=dʒɔ
lexis=ˈlɛksəs
dysgenesis=dɪsˈdʒɛnəsəs
occipitomastoid=ɑkˌsɪpᵻdoʊˈmæˌstɔɪd
ramsar=ˈræmsɑr
buccal=ˈbək(ə)l
labyrinthine=ˌlæb(ə)ˈrɪnˌθin
lev=lɛv
pyramidal=pəˈræməd(ə)l
transglottal=ˌtrænzˈɡlɑdl
due=d(j)u
megalocytosis=ˌmɛɡələsaɪˈtoʊsɪs
disgorge=dɪsˈɡɔrdʒ
lymphocyte=ˈlɪmfəˌsaɪt
hypoglossal=hʌɪpə(ʊ)ˈɡlɒsəl
aperture=ˈæpərˌtʃʊ(ə)r
prussian=ˈprəʃən
infrahyoid=ˌɪnfrəˈhaɪˌɔɪd
localize=ˈloʊkəˌlaɪz
covid=ˈkoʊˌvɪd
histiocytic=ˌhɪstiəˈsɪdɪk
marfan=ˈmɑrˌfæn
extra-nidal=ˌɛkstrəˈnaɪd(ə)l
non-contiguous=ˌnɑnkənˈtɪɡjuəs
rhinitis=raɪˈnaɪdᵻs
neuropore=ˈn(j)ʊrəˌpɔr
smash=smæʃ
infect=ᵻnˈfɛk(t)
treacher=ˈtrɛtʃə
surface=ˈsərfəs
pedicled=ˈpɛdək(ə)ld
bounce=baʊns
strap=stræp
anosmia=æˈnɒsmɪə
slow=sloʊ
basi-cranial=ˌbeɪsəˈkreɪniəl
fixation=fɪkˈseɪʃən
extra-cranial=ˌɛkstrəˈkreɪniəl
epiglottis=ɛpɪˈɡlɒtɪs
eminence=ˈɛmənən(t)s
partition=pɑrˈtɪʃən
visual=ˈvɪʒ(ə)wəl
door=dɔr
cornea=ˈkɔrniə
caffe=ˈkæfeɪ
quadrangular=kwɑˈdræŋɡjələr
neurocutaneous=ˌn(j)ʊroʊˌkjuˈteɪniəs
pori=ˈpɔraɪ
intradural=ˌɪntrəˈd(j)ʊrəl
coronoid=ˈkɒrənɔɪd
driven=ˈdrɪv(ə)n
pial=ˈpaɪəl
dab=dæb
rectus=ˈrɛktəs
differentiate=ˌdɪfəˈrɛn(t)ʃiˌeɪt
caecum=ˈsiːkəm
debris=dəˈbri
age-related=ˌeɪdʒrəˈleɪdᵻd
acidosis=ˌæsəˈdoʊsəs
turbulent=ˈtərbjələnt
melanomata=ˌmɛləˈnoʊmədə
bulb=bəlb
cranio-pharyngeal=ˌkreɪnioʊfəˈrɪndʒ(i)əl
melanoma=ˌmɛləˈnoʊmə
separation=ˌsɛpəˈreɪʃən
cnida=ˈknʌɪdə
trigone=trɪˈɡəʊn
adenolymphoma=ˌædn̩oʊˌlɪmˈfoʊmə
embryology=ˌɛmbriˈɑlədʒi
bacca=ˈbakə
lei=leɪ
flaccid=ˈflæsəd
palatoglossus=ˌpælədoʊˈɡlɑsəs
flap=flæp
palatal=ˈpæləd(ə)l
mucosae=mjuˈkoʊzi
reconstruction=ˌrikənˈstrəkʃən
hemifacial=ˌhɛməˈfeɪʃ(ə)l
committee=ˌkɑməˈti
develop=dəˈvɛləp
trimaran=ˈtraɪməˌræn
albright=ˈɔlbraɪt
panoral=ˌpænˈɔrəl
cart=kɑrt
sentinel=ˈsɛntn̩əl
implication=ˌɪmpləˈkeɪʃən
neuralgia=n(j)ʊˈrældʒə
mallei=ˈmæliˌaɪ
mastication=ˌmæstəˈkeɪʃən
attachment=əˈtætʃmənt
fungus=ˈfəŋɡəs
scalene=ˈskeɪˌlin
vaso-motor=ˌveɪzoʊˈmoʊdər
genioglossus=ˌdʒiniəˈɡlɑsəs
dissect=dəˈsɛk(t)
folliculitis=fəˌlɪkjəˈlaɪdᵻs
vessel=ˈvɛs(ə)l
masseteric=ˌmæsəˈtɛrɪk
destructive=dəˈstrəktɪv
local=ˈloʊkəl
apec=ˈeɪˌpɛk
water=ˈwɔdər
fenestration=ˌfɛnəˈstreɪʃən
dive=daɪv
pterygoid=ˈtɛrəˌɡɔɪd
hurtle=ˈhəːt(ə)l
styloid=ˈstaɪˌlɔɪd
open=ˈoʊp(ə)n
contralateral=ˌkɑntrəˈlædərəl
plenum=ˈplɛn(ə)m
plane=pleɪn
intra-osseous=ˌɪntrəˈɑsiəs
incus=ˈɪŋkəs
lobe=loʊb
dix=diːs
unitistic=ˌjunəˈtɪstɪk
synchondrosis=sɪŋkɒnˈdrəʊsɪs
free=fri
augmentation=ˌɔɡmənˈteɪʃən
cheek=tʃik
capa=ˈkɑːpə
chondrocranium=ˌkɑndrəˈkreɪniəm
gloss-epiglottic=ˌɡlɔsoʊˌɛpəˈɡlɑdɪk
ebb=ɛb
xxxx=ˌfɔrˈɛks
genital=ˈdʒɛnəd(ə)l
pendred=ˈpɛndrəd
necrobacillosis=ˌnɛkroʊˌbæsəˈloʊsəs
dermal=ˈdərm(ə)l
palate=ˈpælət
blue=blu
marble=ˈmɑrbəl
neuroma=n(j)ʊˈroʊmə
gorlin=ˈɡɔrlən
cap=kæp
agger=ˈæɡər
fascicular=fəˈsɪkjələr
thin=θɪn
gingiva=dʒᵻnˈdʒaɪvə
vallecula=vəˈlɛkjələ
horner=ˈhɔrnər
pierce=pɪ(ə)rs
constrictor=kənˈstrɪktər
muscular=ˈməskjələr
carcinomatous=ˌkɑrsəˈnɑmədəs
suture=ˈsutʃər
delphian=ˈdɛlfiən
sturge-weber=stəːdʒˈwɛbə
inclusion=ᵻnˈkluʒ(ə)n
mento=ˈmɛnˌtoʊ
spinose=spʌɪˈnəʊs
cavity=ˈkævədi
rhinosinusitis=ˌraɪnoʊˌsaɪnəˈsaɪdᵻs
dentition=dɛnˈtɪʃən
ectodermal=ˌɛktəˈdərm(ə)l
twell=twɛl
supracoracoid=ˌsuprəˈkɔrəˌkɔɪd
incomplete=ˌɪnkəmˈplit
non=nɑn
irradiation=ᵻˌreɪdiˈeɪʃən
non-toxic=nɑnˈtɑksɪk
fungoidal=ˌfəŋˈɡɔɪd(ə)l
angioedema=ˌændʒioʊəˈdimə
ant=ænt
chylous=ˈkaɪləs
expect=ᵻkˈspɛk(t)
perineural=ˌpɛrəˈn(j)ʊrəl
incisive=ᵻnˈsaɪsɪv
chocolate=ˈtʃɔk(ə)lət
dumbbell=ˈdəmˌbɛl
lens=lɛnz
commissure=ˈkɑməˌʃʊr
deviate=ˈdiviˌeɪt
pacchionian=ˌpækiˈoʊniən
compartment=kəmˈpɑrtmənt
lw=ˌɛlˈdəbəlˌju
vestibulocochlear=vɛˌstɪbjəloʊˈkoʊkliər
adult=əˈdəlt
medical=ˈmɛdək(ə)l
osteodermal=ˌɑstioʊˈdərm(ə)l
dwarf=d(w)ɔrf
mucin=ˈmjus(ə)n
mild=maɪld
aural=ˈɔrəl
fibro-lipoma=ˌfaɪbroʊləˈpoʊmə
familial=fəˈmɪljəl
petrosal=pɛˈtroʊs(ə)l
pseudogout=ˌsudoʊˈɡaʊt
empest=əmˈpɛst
hypophysial=hʌɪpəʊˈfɪzɪəl
trapezius=trəˈpiːzɪəs
pedunculated=pəˈdəŋkjəˌleɪdᵻd
transfer=ˈtræn(t)sfər
xeroderma=ˌzɪrəˈdərmə
group=ɡrup
miniature=ˈmɪn(i)əˌtʃʊ(ə)r
deli=ˈdɛli
nasolabial=ˌneɪzoʊˈleɪbiəl
dene=diːn
granulation=ˌɡrænjəˈleɪʃən
ossicular=ɑˈsɪkjələr
unix=ˈjunɪks
electrode=əˈlɛktroʊd
invasion=ᵻnˈveɪʒən
monostatic=ˌmɑnoʊˈstædɪk
embryopathy=ˌɛmbriˈɑpəθi
hyo-epiglottic=ˌhaɪoʊˌɛpəˈɡlɑdɪk
symphysis=ˈsɪmfɪsɪs
sensorineural=ˌsɛn(t)səriˈn(j)ʊrəl
inherit=ᵻnˈhɛrət
lymphadenitis=lɪmfadɪˈnʌɪtɪs
retrobulbar=ˌrɛtroʊˈbəlbər
tubercle=ˈt(j)ubərk(ə)l
cocaine=koʊˈkeɪn
levator=ləˈveɪdər
appendixes=əˈpɛndᵻksᵻz
mensa=ˈmɛn(t)sə
geniohyoid=ˌdʒinioʊˈhaɪˌɔɪd
epitympanic=ˌɛpɪtɪmˈpanɪk
sellie=ˈsɛli
antibody=ˈæn(t)əˌbɑdi
ramus=ˈreɪməs
intranidal=ˌɪntrəˈnaɪd(ə)l
sporadic=spəˈrædɪk
hogskin=ˈhɔɡˌskɪn
hypercalcaemia=ˌhaɪpərˌkælˈsimiə
tritical=ˈtrɪtɪkəl
suppurative=ˈsəpjəˌreɪdɪv
disassociate=ˌdɪsəˈsoʊʃiˌeɪt
periodontal=ˌpɛrioʊˈdɑn(t)l
maxilla=mækˈsɪlə
stickler=ˈstɪk(ə)lər
lesser=ˈlɛsər
myopia=maɪˈoʊpiə
annulus=ˈænjələs
sheath=ʃiθ
turbinate=ˈtəːbɪnət
capsule=ˈkæpsəl
malleus=ˈmæliəs
rami=ˈreɪˌmaɪ
lymphoblastic=ˌlɪmfəˈblæstɪk
calcific=ˌkælˈsɪfɪk
af=æf
pouch=paʊtʃ
coalescent=ˌkoʊəˈlɛsənt
goitre=ˈɡɔɪdər
abducens=æbˈd(j)us(ə)nz
pharyngo-oesophageal=fəˌrɪŋɡoʊəˌsɑfəˈdʒiəl
acinic=əˈsɪnɪk
dendritic=dɛnˈdrɪdɪk
edge=ɛdʒ
bruxism=ˈbrəkˌsɪzəm
par=pɑr
confluence=ˈkɑnfləwən(t)s
clinoid=ˈklʌɪnɔɪd
perioptic=ˌpɛriˈɑptɪk
laryngotracheal=ləˌrɪŋɡoʊˈtreɪkiəl
polyostotic=ˌpɑlioʊˈstɑdɪk
lamella=ləˈmɛlə
genu=ˈdʒiːnjuː
pseudofracture=ˈsudoʊˌfræk(t)ʃər
neurovascular=ˌn(j)ʊroʊˈvæskjələr
crus=krʌs
endophytic=ˌɛndəˈfɪdɪk
hefner=ˈhɛfnə
hard=hɑrd
orbitosphenoid=ˌɔrbədoʊˈsfiˌnɔɪd
Mensae=ˈmɛnsaɪ
major=ˈmeɪdʒər
digastric=daɪˈɡæstrɪk
infra-orbital=ˌɪnfrəˈɔrbəd(ə)l
flow=floʊ
neurilemmoma=ˌn(j)ʊrələˈmoʊmə
confluent=ˈkɒnfluːənt
pigmentose=ˈpɪɡmənˌtoʊs
manubrium=məˈnubriəm
incisor=ᵻnˈsaɪzər
midfacial=ˌmɪdˈfeɪʃ(ə)l
appendix=əˈpɛndɪks
alt=ɑlt
maxillae=mækˈsɪli
physiologic=ˌfɪziəˈlɑdʒɪk
aniridia=ænaɪəˈrɪdɪə
nonan=ˈnoʊnən
camel=ˈkæm(ə)l
tensor=ˈtɛn(t)sər
attach=əˈtætʃ
sepsis=ˈsɛpsəs
blood=bləd
native=ˈneɪdɪv
dura=djʊərə
cornu=ˈkɔːnjuː
xerostomia=ˌzɪroʊˈstoʊmiə
collie=ˈkɑli
hypaesthesia=hɪpɪsˈθiːsɪə
gingivae=dʒᵻnˈdʒaɪvi
sequence=ˈsikwən(t)s
drive=draɪv
mucocutaneous=ˌmjukoʊˌkjuˈteɪniəs
arbour=ˈɑrbər
pillar=ˈpɪlər
direct=dəˈrɛk(t)
falciform=ˈfælsəˌfɔrm
zygomatic=ˌzaɪɡəˈmædɪk
divide=dəˈvaɪd
ecbatic=ɛkˈbatɪk
olivary=ˈɑləˌvɛri
recti=ˈrɛkˌtaɪ
epithelioma=ɛpɪˌθiːlɪˈəʊmə
membranous=ˈmɛmbrənəs
spasm=ˈspæzəm
hyoglossus=ˌhaɪoʊˈɡlɔsəs
riedel=ˈrid(ə)l
aspen=ˈɑːspən
superionic=ˌsupəraɪˈɑnɪk
canine=ˈkeɪˌnaɪn
paraneoplastic=ˌpɛrəˌnioʊˈplæstɪk
post-vaccinal=ˌpoʊs(t)ˈvæksən(ə)l
deletion=dəˈliʃən
jugulodigastric=ˌdʒəɡjəloʊˌdaɪˈɡæstrɪk
axil=ˈaksɪl
neoplasia=ˌnioʊˈpleɪʒ(i)ə
raphe=ˈreɪfi
petro-occipital=ˌpɛtroʊɑkˈsɪpəd(ə)l
detachment=dəˈtætʃmənt
collins=ˈkɑlənz
place=pleɪs
site=saɪt
capias=ˈkapɪas
atoner=əˈtəʊnə
dorsum=ˈdɔrsəm
cranial=ˈkreɪniəl
cranio-facial=ˌkreɪnioʊˈfeɪʃ(ə)l
partial=ˈpɑrʃ(ə)l
parotitis=ˌpɛrəˈtaɪdᵻs
nucleus=ˈn(j)ukliəs
nutrient=ˈn(j)utriənt
aspergillum=aspəˈdʒɪləm
dentine=ˈdɛnˌtin
ganglion=ˈɡæŋɡliən
atrioventricular=ˈeɪtrɪəʊvɛnˈtrɪkjʊlə
retinal=ˈrɛtnˌæl
silent=ˈsaɪlənt
sarcoid=ˈsɑːkɔɪd
thyro-hyoid=ˌθaɪrəˈhaɪˌɔɪd
hiatus=haɪˈeɪdəs
mental=ˈmɛn(t)l
hamulus=ˈhamjuːləs
timpani=ˈtɪmpəni
bad=bæd
muscularis=ˌməskjəˈlɛrəs
glaucoma=ɡlɔˈkoʊmə
multiplicity=ˌməltəˈplɪsᵻdi
vaso-constrictive=ˌveɪzoʊkənˈstrɪktɪv
eustachian=juːˈsteɪʃən
dystrophic=dɪˈstrɑfɪk
nonsuch=ˈnənˌsətʃ
magma=ˈmæɡmə
phrenic=ˈfrɛnɪk
oval=ˈoʊv(ə)l
basi-sphenoid=ˌbeɪsəˈsfiˌnɔɪd
preganglionic=ˌpriˌɡæŋɡliˈɑnɪk
migrant=ˈmaɪɡr(ə)nt
cataract=ˈkædəˌræk(t)
true=tru
bell=bɛl
clavicle=ˈklavɪk(ə)l
element=ˈɛləmənt
parotiditis=pəˌrɑdəˈdaɪdᵻs
zonule=ˈzəʊnjuːl
virus=ˈvaɪrəs
radical=ˈrædək(ə)l
glottis=ˈɡlɑdəs
miscellaneous=ˌmɪsəˈleɪniəs
decompression=ˌdikəmˈprɛʃən
enophthalmus=ɛnɒfˈθalməs
globular=ˈɡlɑbjələr
edition=əˈdɪʃən
melanosis=ˌmɛləˈnoʊsəs
letterer-siwe=ˌlɛdərərˈsivə
rhinorrhoea=ˌraɪnəˈriə
ameloblastoma=əˌmɛloʊˌblæˈstoʊmə
proliferation=prəˌlɪfəˈreɪʃən
straight=streɪt
dilatation=ˌdɪləˈteɪʃən
gene=dʒin
framework=ˈfreɪmˌwərk
antrum=ˈæntrəm
gusher=ˈɡəʃər
temporomandibular=ˌtɛmpəroʊˌmænˈdɪbjələr
myxoma=mɪkˈsoʊmə
mucosa=mjuˈkoʊzə
fibroplasia=ˌfaɪbrəˈpleɪʒ(i)ə
nose=noʊz
kiss=kɪs
touch=tətʃ
surround=səˈraʊnd
american=əˈmɛr(ə)k(ə)n
hear=hɪ(ə)r
relate=rəˈleɪt
alar=ˈeɪlər
ostium=ˈɑstiəm
ocular=ˈɑkjələr
buccinator=ˈbʌksɪneɪtə
rind=raɪnd
sphenoidal=sfɪˈnɔɪdəl
mylohyoid=ˌmaɪloʊˈhaɪˌɔɪd
chondroid=ˈkɒndrɔɪd
loop=lup
ciliary=ˈsɪliˌɛri
component=kəmˈpoʊnənt
geniculate=dʒəˈnɪkjələt
uvula=ˈjuvjələ
yercum=ˈjəːkəm
nervose=nərˈvoʊs
exit=ˈɛɡzət
abducentes=ˌæbd(j)uˈsɛntiz
post=poʊst
paramastoid=ˌpɛrəˈmæsˌtɔɪd
appendices=əˈpɛndəˌsiz
non-vascular=nɑnˈvæskjələr
tortuous=ˈtɔrtʃ(əw)əs
herpetic=həˈpɛtɪk
singular=ˈsɪŋɡjələr
mycetoma=ˌmaɪsəˈtoʊmə
root=rut
nasolacrimal=ˌneɪzoʊˈlækrəm(ə)l
chep=tʃɛp
actinomyces=ˌæktənoʊˈmaɪsiz
pseudo-base=ˈsudoʊˌbeɪs
epiglottic=ɛpɪˈɡlɒtɪk
dwarfism=ˈd(w)ɔrˌfɪzəm
varicosity=ˌvɛrəˈkɑsədi
adenoidal=ˌædnˈɔɪd(ə)l
transracial=ˌtrænzˈreɪʃ(ə)l
thrombophlebitis=ˌθrɑmboʊfləˈbaɪdᵻs
palatine=ˈpæləˌtaɪn
ophthalmic=ɑpˈθælmɪk
spectrum=ˈspɛktrəm
elastic=əˈlæstɪk
mastoiditis=ˌmæstɔɪˈdaɪdᵻs
loss=lɔs
microphthalmos=ˌmaɪkrɑpˈθælməs
livid=ˈlɪvᵻd
corniculate=kɔrˈnɪkjələt
palsy=ˈpɔlzi
issue=ˈɪʃ(j)u
levin=ˈlɛvən
branch=bræn(t)ʃ
labyrinth=ˈlæb(ə)ˌrɪnθ
jugular=ˈdʒəɡjələr
mastoidectomy=ˌmæstɔɪˈdɛktəmi
nasopalatine=ˌneɪzoʊˈpæləˌtaɪn
unossified=ˌənˈɑsəˌfaɪd
plie=pliˈeɪ
aggressive=əˈɡrɛsɪv
cylindrical=səˈlɪndrək(ə)l
canvas=ˈkænvəs
acinous=ˈæsənəs
lymphogranuloma=ˌlɪmfəʊɡranjʊˈləʊmə
anti=ˈænˌtaɪ
submaxillary=ˌsəbˈmæksəˌlɛri
crista=ˈkrɪstə
mycoses=maɪˈkoʊsiz
kilian=ˈkɪlɪən
critical=ˈkrɪdək(ə)l
drove=droʊv
pit=pɪt
porus=ˈpɔrəs
mel=mɛl
approach=əˈproʊtʃ
ar=ˌeɪˈɑr
neurolemmoma=ˌn(j)ʊroʊləˈmoʊmə
retinitis=ˌrɛtnˈaɪdᵻs
cillosis=sɪˈləʊsɪs
fungi=ˈfənˌdʒaɪ
bibi=ˈbiːbiː
quadrifid=ˈkwɑdrəˌfɪd
ethmoid=ˈɛθˌmɔɪd
gar=ɡɑr
luetic=l(j)uːˈɛtɪk
crest=krɛst
replacement=rəˈpleɪsm(ə)nt
diplopia=dɪˈpləʊpɪə
danger=ˈdeɪndʒər
otorrhoea=ˌoʊdəˈriə
osteochondritis=ˌɑstioʊˌkɑnˈdraɪdᵻs
tympanic=tɪmˈpænɪk
isolate=ˈaɪsəˌleɪt
metaplasia=ˌmɛdəˈpleɪʒ(i)ə
spindle=ˈspɪnd(ə)l
corectomy=kəˈrɛktəmi
prevertebral=ˌpriˈvərdəbrəl
meet=mit
vertebro=ˌvərdəbroʊˈstərn(ə)l
glory=ˈɡlɔri
accuse=əˈkjuz
ana=ˈɑnə
premaxillary=priˈmæksəˌlɛri
radionecrosis=ˌreɪdioʊnəˈkroʊsəs
tonsil=ˈtɑn(t)s(ə)l
cerebritis=sɛrɪˈbrʌɪtɪs
fenestral=fɪˈnɛstral
bill=bɪl
tripod=ˈtraɪˌpɑd
cochlea=ˈkɒkliːə
bronc=brɑŋk
papilla=pəˈpɪlə
radicular=rəˈdɪkjələr
extra-ocular=ˌɛkstrəˈɑkjələr
robin=ˈrɑbən
artefact=ˈɑrdəˌfæk(t)
medialize=ˈmidiəˌlaɪz
stenosing=stɪˈnəʊsɪŋ
lingula=ˈlɪŋɡjələ
collagen=ˈkɑlədʒən
circumvallate=səːkəmˈvaleɪt
strut=strət
larva=ˈlɑrvə
around=əˈraʊnd
dicrotic=daɪˈkrɑdɪk
dehiscence=dɪˈhɪsəns
magnum=ˈmæɡnəm
ridge=rɪdʒ
apert=əˈpəːt
deafness=ˈdɛfnəs
pathologic=ˌpæθəˈlɑdʒɪk
anvil=ˈænvəl
dorsal=ˈdɔrs(ə)l
morning=ˈmɔrnɪŋ
ach=ɑk
nematocyst=ˈnimədəˌsɪst
minor=ˈmaɪnər
content=ˈkɑntɛnt
communism=ˈkɑmjəˌnɪzəm
trismus=ˈtrɪzməs
recept=ˈriˌsɛpt
auditory=ˈɔdəˌtɔri
dentigerous=dɛnˈtɪdʒərəs
bama=ˈbæmə
cox=kɑks
basilary=ˈbasɪləri
hyoid=ˈhaɪˌɔɪd
process=ˈprɑˌsɛs
temporalis=tɛmpəˈreɪlɪs
symmetric=səˈmɛtrɪk
cherubic=tʃəˈr(j)uːbɪk
phthisis=ˈθaɪsəs
mantle=ˈmæn(t)əl
extra-orbital=ˌɛkstrəˈɔrbəd(ə)l
norie=ˈnɔri
vertebra=ˈvərdəbrə
colloid=ˈkɑˌlɔɪd
radiate=ˈreɪdiˌeɪt
occiput=ˈɑksəpət
pleuropathy=plʊˈrɑpəθi
lateralized=ˈlædərəˌlaɪzd
alisphenoid=ˌæləˈsfiˌnɔɪd
infiltrate=ᵻnˈfɪlˌtreɪt
tophaceous=təʊˈfeɪʃəs
extend=ɪkˈstɛnd
mastoid=ˈmæˌstɔɪd
thyro-arytenoid=ˌθaɪroʊəˈrɪtnˌɔɪd
periglottic=ˌpɛrəˈɡlɑdɪk
cold=koʊld
division=dəˈvɪʒən
for=fɔr
sal=sæl
cleft=klɛft
figurae=fɪˈɡjəri
druse=druːz
hoarseness=ˈhɔːsnɪs
plaque=plæk
douane=dwɑn
boundary=ˈbaʊnd(ə)ri
ionize=ˈaɪəˌnaɪz
neurinoma=ˌn(j)urəˈnoʊmə
wall=wɔl
fibro-sarcoma=ˌfaɪbroʊˌsɑrˈkoʊmə
pneumatization=ˌn(j)umədəˈzeɪʃən
tuberculum=təˈbərkjələm
meatal=miˈeɪdl
level=ˈlɛv(ə)l
midline=ˈmɪdˌlaɪn
attic=ˈædɪk
precursor=ˈpriˌkərsər
chorda=ˈkɔːdə
conus=ˈkoʊnəs
blowout=ˈbloʊˌaʊt
glossopharyngeal=ˌɡlɔsoʊˌfɛrənˈdʒiəl
infiltrative=ˈɪnfɪlˌtreɪdɪv
residual=rəˈzɪdʒ(ə)wəl
malposition=ˌmælpəˈzɪʃən
stapedius=stəˈpiːdɪəs
nodhead=ˈnɑdˌ(h)ɛd
interposition=ˌɪntəpəʊˈzɪʃən
condylar=ˈkɒndɪlə
arytenoid=əˈrɪtnˌɔɪd
trouvere=ˈtruːvəː
gum=ɡəm
oral=ˈɔr(ə)l
schneiderian=ˌʃnaɪˈdɪriən
mural=ˈmjʊr(ə)l
non-hodgkin=nɑnˈhɑdʒk(ə)n
aqueous=ˈɑkwiəs
mucosal=mjuˈkoʊz(ə)l
atheromatous=aθəˈrɒmətəs
live=lɪv
adenitis=ˌædnˈaɪdɪs
iris=ˈaɪrᵻs
odontogenic=oʊˌdɑn(t)əˈdʒɛnɪk
sternebra=ˈstəːnᵻbrə
his=hɪz
necrotic=nəˈkrɑdɪk
xi=zaɪ
bulbil=ˈbəlbəl
odontoma=ˌoʊdɑnˈtoʊmə
bottom=ˈbɑdəm
infundibulum=ɪnfʌnˈdɪbjʊləm
postdental=ˌpoʊs(t)ˈdɛn(t)l
complete=kəmˈplit
laminated=ˈlæməˌneɪdᵻd
submental=ˌsəbˈmɛn(t)l
depression=dəˈprɛʃən
manipulation=məˌnɪpjəˈleɪʃən
nuclei=ˈn(j)ukliˌaɪ
enamel=ᵻˈnæməl
end=ɛnd
anomia=əˈnoʊmiə
pharyngeal=fəˈrɪndʒ(i)əl
uncinate=ˈən(t)sənət
cut=kət
pyriform=ˈpɪrəˌfɔrm
oak=oʊk
devi=ˈdeɪvi
post-graduation=ˌpoʊst ˌɡrædʒəˈweɪʃən
oculomotor=ˌɑkjəloʊˈmoʊdər
medimnus=məˈdɪmnəs
sternocleidomastoid=ˌstərnəˌklaɪdəˈmæˌstɔɪd
oropharyngeal=ˌɔroʊfəˈrɪndʒiəl
semicircular=ˌsɛˌmaɪˈsərkjələr
mycosis=maɪˈkoʊsəs
ipiti=ˈɪpədi
ma=mɑ
sah=sɑː
glottic=ˈɡlɒtɪk
modify=ˈmɑdəˌfaɪ
distensible=dɪˈstɛnsɪb(ə)l
infratentorial=ˌɪnfrəˌtɛnˈtɔriəl
tongue=təŋ
apparatus=ˌæpəˈrædəs
hypopharyngeal=ˌhʌɪpə(ʊ)fəˈrɪndʒiːəl
saccule=ˈsæˌkjul
reparative=rəˈpɛrədɪv
microcephaly=ˌmaɪkroʊˈsɛfəli
area=ˈɛriə
suboccipital=ˌsəbɑkˈsɪpᵻdl
abd=ˌeɪˌbiˈdi
flix=flɪks
annuli=ˈænjəˌlaɪ
myxofibroma=ˌmɪksoʊˌfaɪˈbroʊmə
relationship=rəˈleɪʃənˌʃɪp
melanoses=ˌmɛləˈnoʊsiz
avid=ˈævəd
supraorbital=ˌsuprəˈɔrbədl
vestibule=ˈvɛstəˌbjul
ivi=ˈiːviː
long=lɔŋ
cicad=ˈsɪkad
trap=træp
postinflammatory=ˌpoʊstᵻnˈflæməˌtɔri
ossify=ˈɑsəˌfaɪ
perforator=ˈpərfəˌreɪdər
stylopharyngeus=ˌstaɪloʊˌfɛrənˈdʒiəs
biffy=ˈbɪfi
generalize=ˈdʒɛn(ə)rəˌlaɪz
plunge=pləndʒ
prolapse=proʊˈlæps
mikulicz=ˈmɪkjəˌlɪts
premolar=priˈmoʊlər
staphyloma=stafɪˈləʊmə
coronavirus=kəˈroʊnəˌvaɪrəs
pseudo-fruit=ˈsudoʊˌfrut
tympanosclerosis=ˌtɪmpənoʊskləˈroʊsəs
retina=ˈrɛtn̩ə
naevus=ˈnivəs
perineuritis=ˌpɛrən(j)uˈraɪdᵻs
laryngectomy=larɪnˈdʒɛktəmi
microsomia=ˌmaɪkroʊˈsoʊmiə
tusche=tuʃ
segment=ˈsɛɡm(ə)nt
post-cricoid=ˌpoʊs(t)ˈkraɪˌkɔɪd
periarticular=ˌpɛriˌɑrˈtɪkjələr
guillain-barre=ˌɡɪjamˈbareɪ
vocalic=voʊˈkælɪk
deform=dəˈfɔrm
sclera=ˈsklɛrə
supraglottic=ˌsuprəˈɡlɑdɪk
modiolus=moʊˈdaɪələs
uveal=ˈjuːvɪəl
xxx=ˌɛksˌɛksˈɛks
masseter=məˈsidər
epidemic=ˌɛpəˈdɛmɪk
alibi=ˈæləˌbaɪ
micrographia=ˌmaɪkroʊˈɡræfiə
petromastoid=ˌpɛtroʊˈmæˌstɔɪd
displacement=dɪsˈpleɪsm(ə)nt
orifice=ˈɔrəfəs
pulp=pəlp
cricothyroid=ˌkraɪkoʊˈθaɪˌrɔɪd
aslib=ˈazlɪb
teratogenic=ˌtɛrətə(ʊ)ˈdʒɛnɪk
canaliculus=ˌkænəˈlɪkjələs
tegmen=ˈtɛɡmɛn
retraction=rəˈtrækʃən
waldeyer=ˈvaldʌɪə
alcohol=ˈælkəˌhɔl
periodontitis=ˌpɛrioʊˌdɑnˈtaɪdᵻs
spread=sprɛd
retromaxillary=ˌrɛtroʊˈmæksəˌlɛri
buphthalmos=bʊfˈθalmɒs
bucco=ˌbəkoʊˈneɪz(ə)l
cal=kal
sicca=ˈsɪkə
hyperactive=ˌhaɪpərˈæktɪv
drainage=ˈdreɪnɪdʒ
cricopharyngeal=ˌkraɪkoʊfəˈrɪndʒ(i)əl
sincipital=sɪnˈsɪpɪtəl
implantation=ˌɪmplənˈteɪʃən
cricoid=ˈkraɪˌkɔɪd
shell=ʃɛl
stapes=ˈsteɪˌpiz
forms=fər
X's=ˈɛksəz
pharyngoepiglottic=fəˌrɪŋɡoʊˌɛpəˈɡlɑdɪk
seroma=səˈroʊmə
ijo=ˈidʒoʊ
endemic=ɛnˈdɛmɪk
aditus=ˈædədəs
styloglossus=ˌstaɪloʊˈɡlɔsəs
cemental=sɪˈmɛntəl
pharyngitis=ˌfɛrənˈdʒaɪdᵻs
fusion=ˈfjuʒən
bisphosphonate=ˌbɪsˈfɑsfəˌneɪt
extrinsic=ɪkˈstrɪnzɪk
chain=tʃeɪn
overnet=ˌoʊvərˈnɛt
hot=hɑt
orale=ɔˈreɪli
arrest=əˈrɛst
burkitt=ˈbəːkɪt
codd=kɑd
bar=bɑr
asymmetric=ˌeɪsəˈmɛtrɪk
lymphomatosis=lɪmfəʊməˈtəʊsɪs
scapula=ˈskæpjələ
presphenoid=priˈsfiˌnɔɪd
compromise=ˈkɑmprəˌmaɪz
stylomastoid=stʌɪləʊˈmastɔɪd
foci=ˈfoʊˌsaɪ
secretion=səˈkriʃən
atelectatic=ˌatɪlɛkˈtatɪk
figura=fɪˈɡjərə
intrinsic=ᵻnˈtrɪnzɪk
auriculo=ɔˌrɪkjəloʊˈtɛmp(ə)rəl
into=ˈɪntu
meningoencephalocele=məˌnɪŋɡoʊᵻnˈsɛfəloʊˌsil
dwarves=d(w)ɔrvz
infancy=ˈɪnfən(t)si
ann=æn
ani=ˈɑːniː
trunk=trəŋk
vici=ˈvitʃi
shamble=ˈʃamb(ə)l
other=ˈəðər
supranuclear=ˌsuprəˈn(j)ukliər
myoclonic=ˌmaɪoʊˈklɑnɪk
nile=naɪl
age=eɪdʒ
putid=ˈpjudɪd
chorioid=ˈkɔriˌɔɪd
microvascular=ˌmaɪkroʊˈvæskjələr
meninx=ˈminɪŋ(k)s
even=ˈivən
malaria=məˈlɛriə
mineralize=ˈmɪn(ə)rəˌlaɪz
tuber=ˈt(j)ubər
iter=ˈɪtə
aga=ˈɑɡə
open-air=ˌoʊpən ˈɛ(ə)r
adrenoleukodystrophy=əˌdrinoʊˌlukoʊˈdɪstrəfi
wallerian=wɒˈlɪərɪən
primitive=ˈprɪmədɪv
syrup=ˈsərəp
urea=jʊˈriə
pneuma=ˈn(j)umə
encephalomalacia=ᵻnˌsɛfəloʊməˈleɪʃ(i)ə
typical=ˈtɪpᵻk(ə)l
presylvian=ˌpriˈsɪlviən
non-dramatic=ˌnɑndrəˈmædɪk
evolution=ˌɛvəˈluʃən
alzheimer=ˈɑltsˌ(h)aɪmər
nitrobacter=ˈnaɪtroʊˌbæktər
neuronal=ˈn(j)ʊrən(ə)l
kinase=ˈkaɪˌneɪs
carney=ˈkɑrni
grow=ɡroʊ
human=ˈ(h)jumən
denet=diːˈnɛt
meninges=məˈnɪndʒiz
merry=ˈmɛri
sumac=ˈsuˌmæk
underlie=ˌəndərˈlaɪ
sebaceous=sɪˈbeɪʃəs
preterm=priˈtərm
rendu-osler-weber=ˌrɑnd(j)uˌɑslərˈwɛbər
noia=ˈnɔɪə
parkinson=ˈpɑrkəns(ə)n
non-le=nɑn ˈli
calvarial=kalˈvɛːrɪəl
classic=ˈklæsɪk
pericranial=ˌpɛrəˈkreɪniəl
non-acid=nɑnˈæsɪd
pressure-treated=ˈprɛʃərˌtridᵻd
west=wɛst
lacunar=ˈlæk(j)ənər
mesial=ˈmiziəl
vestigial=vɛˈstɪdʒ(i)əl
mitochondrial=ˌmaɪdəˈkɑndriəl
neuroglial=n(j)ʊˈrɑɡliəl
maple=ˈmeɪpəl
cinereal=sɪˈnɪərɪəl
fabby=ˈfæbi
pres=prɛz
accumulation=əˌkjum(j)əˈleɪʃən
turcian=ˈtərʃən
epileptical=ˌɛpəˈlɛptək(ə)l
impact=ˈɪmˌpæk(t)
hemispheric=ˌhɛməˈsfɪrɪk
simplex=ˈsɪmˌplɛks
parasite=ˈpɛrəˌsaɪt
neurodegeneration=ˌn(j)ʊroʊdəˌdʒɛnəˈreɪʃən
huntingdon=ˈhʌntɪŋdən
non-alcoholic=ˌnɑnælkəˈhɔlɪk
pent=pɛnt
missile=ˈmɪs(ə)l
amnesia=æmˈniːsɪə
amyotrophic=əmaɪəˈtrɒfɪk
eclampsia=ɛˈklampsɪə
pantothenate=ˌpæn(t)oʊˈθɛˌneɪt
megacorpse=ˈmɛɡəˌkɔrps
rickettsial=rəˈkɛtsiəl
glutaric=ɡluˈtɛrɪk
mearns=mərnz
frontotemporal=ˌfrən(t)oʊˈtɛmp(ə)rəl
akan=ɑˈkɑn
reconstitution=ˌriˌkɑn(t)stəˈt(j)uʃən
pressure=ˈprɛʃər
dig=dɪɡ
simplicia=sɪmˈplɪsiə
caravan=ˈkɛrəˌvæn
pontine=ˈpɑnˌtaɪn
epilepsy=ˈɛpəˌlɛpsi
convex=ˌkɑnˈvɛks
arteriosclerosis=ɑrˌtɪrioʊsklᵻˈroʊsəs
scalp=skælp
pseudomorph=ˈsudoʊˌmɔrf
perinatal=ˌpɛrəˈneɪdl
lactic=ˈlæktɪk
anglocentric=ˌæŋɡloʊˈsɛntrɪk
severe=səˈvɪ(ə)r
chemolytic=ˌkiməˈlɪdɪk
immunodeficiency=ˌɪmjənoʊdəˈfɪʃən(t)si
gram=ɡræm
osmond=ˈɑzmən(d)
pseudo-ray=ˈsudoʊˌreɪ
atp=ˌeɪˌtiˈpi
course=kɔrs
megalencephaly=ˌmɛɡəlˌɛnˈsɛfəli
cyanide=ˈsaɪəˌnaɪd
unclassified=ˌənˈklæsəˌfaɪd
bacardi=bəˈkɑrdi
oligo=ˈɑləɡoʊ
limbic=ˈlɪmbɪk
porencephalic=ˌpɔrɛn(t)səˈfælɪk
responsive=rəˈspɑn(t)sɪv
dot=dɑt
arable=ˈɛrəb(ə)l
arm=ɑrm
dagger=ˈdæɡər
kernicterus=kəːˈnɪktərəs
steroid=ˈstɛˌrɔɪd
alcoholic=ˌælkəˈhɔlɪk
dewy=ˈd(j)ui
rant=rænt
thick=θɪk
where=(h)wɛ(ə)r
clipper=ˈklɪpər
organic=ɔrˈɡænɪk
abusive=əˈbjusɪv
serpentine=ˈsəːpəntʌɪn
mela=ˈmeɪlɑ
hypotensive=hʌɪpəʊˈtɛnsɪv
interhemispheric=ˌɪn(t)ərˌhɛməˈsfɛrɪk
lactate=ˈlækˌteɪt
spontaneous=spɑnˈteɪniəs
cryptococcosis=ˌkrɪptəkɑˈkoʊsəs
sore=sɔr
black=blæk
leukodystrophy=ˌlukəˈdɪstrəfi
streptococcal=strɛptəˈkɒkəl
apoplexy=ˈapəʊplɛksi
pearson=ˈpɪrs(ə)n
leucoencephalitis=ˌlukoʊᵻnˌsɛfəˈlaɪdᵻs
simplices=ˈsɪmpləˌsiz
oxygen=ˈɑksədʒ(ə)n
aciduric=ˌæsəˈd(j)ʊrɪk
neuroectodermal=ˌn(j)ʊroʊˌɛktəˈdərm(ə)l
cosmoplastic=kɒzməʊˈplastɪk
high-grade=ˌhaɪˈɡreɪd
tay-sachs=teɪˈsaks
hyperglycaemia=ˌhaɪpərˌɡlaɪˈsimiə
ventriculitis=vɛntrɪkjʊˈlʌɪtɪs
myopathy=maɪˈɑpəθi
basilar=ˈbasɪlə
urine=ˈjʊrən
neurectodermal=n(j)uˈrɛktəˌdərməl
drug=drəɡ
hemiatrophy=ˌhɛmiˈætrəfi
metachromatic=ˌmɛdəˌkroʊˈmædɪk
turbot=ˈtərbət
intravascular=ˌɪntrəˈvæskjələr
arteriosclerotic=ɑrˌtɪrioʊskləˈrɑdɪk
remote=rəˈmoʊt
osler-weber-rendu=ˌɑslərˌwɛbərˈrɑnd(j)u
embole=ˈɛmbəliː
gliosarcoma=ˌɡlʌɪəʊsɑːˈkəʊmə
herald=ˈhɛrəld
cycle=ˈsaɪkəl
continuum=kənˈtɪnjəwəm
term=tərm
differentiation=ˌdɪfəˌrɛn(t)ʃiˈeɪʃən
alexander=ˌæləɡˈzændər
ophthalmoplegia=ˌɑpθə(l)məˈpli(d)ʒ(i)ə
episode=ˈɛpəˌsoʊd
neuroepithelial=ˌn(j)ʊroʊˌɛpəˈθiliəl
compensatory=kəmˈpɛn(t)səˌtɔri
curvature=ˈkərvətʃʊ(ə)r
sagittal=ˈsædʒəd(ə)l
katakana=ˌkɑdəˈkɑnə
aetiology=ˌidiˈɑlədʒi
chump=tʃəmp
back=bæk
rotation=roʊˈteɪʃən
fail=feɪl
intraspinal=ˌɪntrəˈspaɪn(ə)l
miscegenic=ˌmɪsəˈdʒɛnɪk
amyotrophy=æmɪˈɒtrəfɪ
sequela=siˈkwɛlə
neurapraxia=ˌn(j)ʊrəˈpræksiə
periodontosis=ˌpɛrioʊˌdɑnˈtoʊsəs
pseudarthrosis=ˌsudˌɑrˈθroʊsəs
carcinosis=ˌkɑrsəˈnoʊsəs
acondylous=əˈkɑndələs
asn=ˌeɪˌɛsˈɛn
myelosclerosis=ˌmaɪəloʊskləˈroʊsəs
erythropoietic=əˌrɪθrəˌpɔɪˈɛdɪk
distractible=dəˈstræktəb(ə)l
mucolipidoses=ˌmjukoʊˌlɪpəˈdoʊsiz
ado=əˈdu
stinger=ˈstɪŋər
non-disjunction=ˌnɑndɪsˈdʒəŋ(k)ʃən
assimilation=əˌsɪməˈleɪʃən
condyle=ˈkɑnˌdaɪl
shoveller=ˈʃʌv(ə)lə
poliomyelitis=ˌpoʊlioʊˌmaɪəˈlaɪdᵻs
arthroplasty=ˈɑrθrəˌplæsti
absent=ˈæbsənt
retinoid=ˈrɛtnˌɔɪd
dimple=ˈdɪmp(ə)l
eid=id
fever=ˈfivər
pilonidal=ˌpaɪləˈnaɪd(ə)l
combine=kəmˈbaɪn
rip=rɪp
arg=ˌeɪˌɑrˈdʒi
han=hæn
hypervascular=ˌhaɪpərˈvæskjələr
subauricular=ˌsəbˌɔˈrɪkjələr
instrumentation=ˌɪn(t)strəmənˈteɪʃən
cubital=ˈkjuːbɪtəl
translation=trænzˈleɪʃən
terminology=ˌtərməˈnɑlədʒi
segmental=sɛɡˈmɛn(t)l
scallop=ˈskɑləp
proatlas=proʊˈætləs
invagination=ɪnvadʒɪˈneɪʃən
arthrosis=ˌɑrˈθroʊsɪs
seat=sit
porticus=ˈpɔrdəkəs
opportunistic=ˌɑpərt(j)uˈnɪstɪk
balance=ˈbælən(t)s
forester=ˈfɔrəstər
variable=ˈvɛriəb(ə)l
hypervitaminosis=ˌhaɪpərˌvaɪdəməˈnoʊsəs
neural=ˈn(j)ʊr(ə)l
syringomyelia=səˌrɪŋɡoʊˌmaɪˈilɪk
osteoporotic=ˌɑstioʊpəˈrɑdɪk
myelitis=ˌmaɪəˈlaɪdᵻs
interspinous=ɪntəˈspʌɪnəs
accelerate=əkˈsɛləˌreɪt
maerl=ˈmɑərl
advance=ədˈvæn(t)s
syndesmosis=ˌsɪndɛzˈmoʊsəs
homeobox=ˈhoʊmiəˌbɑks
unstable=ˌənˈsteɪb(ə)l
intersegmental=ˌɪntəsɛɡˈmɛntəl
supply=səˈplaɪ
corm=kɔrm
haematomyelia=ˌhimədoʊˌmaɪˈiliə
below=bəˈloʊ
garda=ˈɡɑrdə
apophysis=əˈpɒfɪsɪs
spur=spər
barf=bɑrf
neuromuscular=ˌn(j)ʊroʊˈməskjələr
neuroblastic=ˌn(j)ʊrəˈblæstɪk
coccygeal=kɒkˈsɪdʒiːəl
myeloproliferative=ˌmaɪəloʊprəˈlɪfərədɪv
wedge=wɛdʒ
bursitis=bəːˈsʌɪtɪs
neurulation=ˌn(j)ʊrəˈleɪʃən
osteophyte=ˈɑstioʊˌfaɪt
state=steɪt
phlebitis=fləˈbaɪdᵻs
neurotmesis=ˌn(j)ʊroʊtəˈmisᵻs
migration=ˌmaɪˈɡreɪʃən
method=ˈmɛθəd
non-union=nɑnˈjunj(ə)n
than=ðæn
plantar=ˈplæn(t)ər
progression=prəˈɡrɛʃən
leakage=ˈlikɪdʒ
postinfectious=ˌpoʊstᵻnˈfɛkʃəs
all=ɔl
cob=kɑb
agnogenic=ˌæɡnəˈdʒɛnɪk
burner=ˈbərnər
lumberjack=ˈləmbərˌdʒæk
diarthrosis=ˌdʌɪɑːˈθrəʊsɪs
unknown=ˌənˈnoʊn
monodontid=ˌmɑnəˈdɑn(t)əd
in-ovo=ˌɪn ˈoʊˌvoʊ
staphylococcal=ˌstaf(ə)ləˈkɒkəl
scoliosis=skɒlɪˈəʊsɪs
a'=ɔ
sensory=ˈsɛn(t)səri
disjunction=dɪsˈdʒəŋ(k)ʃən
myelomalacia=ˌmaɪəloʊməˈleɪʃ(i)ə
asymmetrical=ˌeɪsəˈmɛtrək(ə)l
thoracolumbar=ˌθɔrəkoʊˈləmˌbɑr
terminable=ˈtərmənəbəl
adjacent=əˈdʒeɪs(ə)nt
pantopaque=ˈpæn(t)oʊˌpeɪk
traction=ˈtrækʃən
melanotic=ˌmɛləˈnɑdɪk
foraminate=fɒˈramɪnət
mother=ˈməðər
autonomic=ˌɔdəˈnɑmɪk
heterogeneous=ˌhɛdərəˈdʒiniəs
monticulus=mɑnˈtɪkjələs
obstetric=əbˈstɛtrɪk
niemann-pick=ˌnimənˈpik
expansion=ɪkˈspæn(t)ʃən
sequestrate=ˈsikwəˌstreɪt
phase=feɪz
synarthrosis=sɪnɑːˈθrəʊsɪs
pediculosis=pəˌdɪkjəˈloʊsəs
melanocytic=ˌmɛlənoʊˈsɪdɪk
recombinant=riˈkɑmbənənt
cytosine=ˈsaɪdəˌsin
extrusion=ɪkˈstruʒən
sequester=sɪˈkwɛstə
expandable=ɪkˈspændəb(ə)l
osteogenic=ˌɑstioʊˈdʒɛnɪk
radiological=ˌreɪdiəˈlɑdʒək(ə)l
epicondylitis=ˌɛpəˌkɑndəˈlaɪdəs
rotatory=ˈroʊdəˌtɔri
myeloid=ˈmaɪəˌlɔɪd
broadshare=ˈbrɔdˌʃɛ(ə)r
postirradiation=ˌpoʊstᵻˌreɪdiˈeɪʃən
precondylar=ˌpriˈkɑndələr
physiological=ˌfɪziəˈlɑdʒək(ə)l
peroneal=ˌpɛrəˈniəl
fix=fɪks
haemolytic=-ˈlɪtɪk
paraplegia=ˌpɛrəˈplidʒ(i)ə
spina=ˈspʌɪnə
laminectomy=lamɪˈnɛktəmi
ulnar=ˈəlnər
fenestrated=fɪˈnɛstreɪtɪd
limbus=ˈlɪmbəs
cierge=sɪ(ə)r(d)ʒ
meningomyelocele=məˌnɪŋɡoʊˈmaɪəloʊˌsil
herniated=ˈhəːnɪeɪtɪd
ad-rem=ˌæd ˈrɛm
chemical=ˈkɛmək(ə)l
hardware=ˈhɑrdˌwɛ(ə)r
imbalance=ɪmˈbælən(t)s
blunt=blənt
bow=boʊ
positional=pəˈzɪʃ(ə)n(ə)l
hisn=ˈhɪzən
rizzer=ˈrɪzər
spondylosis=spɒndɪˈləʊsɪs
close=kloʊz
syphilitic=ˌsɪf(ə)ˈlɪdɪk
schistosomiasis=ˌskɪstəʊsəʊˈmʌɪəsɪs
rotary=ˈroʊdəri
displace=dɪsˈpleɪs
juxta-articular=ˌdʒəkstəˌɑrˈtɪkjələr
anaemiae=əˈnimiˌi
subsidence=səbˈsaɪdn(t)s
malalignment=ˌmæləˈlaɪnmənt
osteoblastic=ˌɑstioʊˈblæstɪk
polyneuropathy=ˌpɑlin(j)uˈrɑpəθi
den=dɛn
diastrophic=daɪəˈstrɒfɪk
puncture=ˈpəŋ(k)(t)ʃər
screw=skru
neurosyphilis=ˌn(j)ʊroʊˈsɪf(ə)lᵻs
failure=ˈfeɪljər
coccyx=ˈkɑkˌsɪks
subaerial=ˌsəbˈɛriəl
treat=trit
genetic=dʒəˈnɛdɪk
impression=ᵻmˈprɛʃən
radiculopathy=ˌrædəkjəˈlɑpəθi
cauda=ˈkɔːdə
stretch=strɛtʃ
abnormal=æbˈnɔrm(ə)l
pycnodysostosis=ˌpɪknoʊˌdɪsoʊˈstoʊsəs
amt=æmt
atlas=ˈætləs
paramagnetic=ˌpɛrəˌmæɡˈnɛdɪk
peridural=ˌpɛrəˈd(j)ʊrəl
iniencephaly=ˌɪniˌɛnˈsɛfəli
lam=læm
ligamentous=ˌlɪɡəˈmɛn(t)əs
postural=ˈpɑstʃərəl
shear=ʃɪ(ə)r
regenerate=riˈdʒɛnəˌreɪt
bifid=ˈbaɪfᵻd
centroid=ˈsɛnˌtrɔɪd
clay=kleɪ
prasinous=ˈpreɪzənəs
ossiculum=ɑˈsɪkjəl(ə)m
calcify=ˈkalsɪfʌɪ
maximum=ˈmæksəməm
sacral=ˈseɪkrəl
telangiectatic=-ˈtætɪk
subclassification=ˈsəbˌklæsəfəˌkeɪʃən
fragment=ˈfræɡmənt
lumbo-abdominal=ˌləmboʊˌæbˈdɑmən(ə)l
terminal=ˈtərmənəl
osteopenia=ˌɑstiəˈpiniə
mater=ˈmeɪdər
variation=ˌvɛriˈeɪʃən
occipitoatlantal=ɑkˌsɪpᵻdoʊətˈlæn(t)l
shock=ʃɑk
tertius=ˈtərʃ(i)əs
amphiarthrosis=ˌæmfɪɑːˈθrəʊsɪs
drop=drɑp
post-polio=ˌpoʊs(t)ˈpoʊlioʊ
neuralgic=n(j)ʊˈrældʒɪk
denia=ˈdiːnɪə
segmentation=ˌsɛɡmənˈteɪʃən
crown=kraʊn
monomeric=ˌmɑnəˈmɛrɪk
resorption=rəˈsɔrpʃən
broad=brɔd
pang=pæŋ
gibbs=ɡɪbz
regression=rəˈɡrɛʃən
rotational=roʊˈteɪʃ(ə)n(ə)l
preshrink=ˌpriˈʃrɪŋk
intrathecal=ˌɪntrəˈθik(ə)l
syrinx=ˈsɪrɪŋks
brucella=bruˈsɛlə
intervertebral=ɪntəˈvəːtɪbrəl
nomenclature=ˈnoʊmənˌkleɪtʃ(ə)r
adhesion=ædˈhiʒ(ə)n
pronator=ˈproʊˌneɪdər
haemodialysis=ˌhiməˌdaɪˈæləsəs
orthograde=ˈɔrθoʊˌɡreɪd
intravertebral=ˌɪntrəˈvərdəbrəl
engorgement=ɛnˈɡɔːdʒmənt
echinococcosis=əˌkaɪnəkɑˈkoʊsəs
ab=æb
amputation=ˌæmpjəˈteɪʃən
mucolipidosis=ˌmjukoʊˌlɪpəˈdoʊsəs
block=blɑk
cellular=ˈsɛljələr
isthmic=ˈɪs(θ)mɪk
extrude=ɪkˈstrud
recent=ˈris(ə)nt
internode=ˈɪn(t)ərˌnoʊd
dissociation=dᵻˌsoʊʃiˈeɪʃən
spacer=ˈspeɪsər
anaemia=əˈnimiə
after=ˈæftər
morphogenetic=ˌmɔrfədʒəˈnɛdɪk
model=ˈmɑd(ə)l
methotrexate=ˌmɛθəˈtrɛkˌseɪt
electrical=əˈlɛktrək(ə)l
spinous=ˈspaɪnəs
redundant=rəˈdənd(ə)nt
osteocartilaginous=ˌɑstioʊˌkɑrdlˈædʒənəs
duplicate=ˈd(j)upləˌkeɪt
ventriculus=vɛnˈtrɪkjʊləs
equine=ˈiˌkwaɪn
mycoplasmata=ˌmaɪkəˈplæzmətə
centre=ˈsɛn(t)ər
pedicle=ˈpɛdək(ə)l
mycoplasma=ˌmaɪkoʊˈplæzmə
susceptibility=səˌsɛptəˈbɪlᵻdi
osteoarthrosis=ˌɑstioʊˌɑrˈθroʊsəs
myelopathy=ˌmaɪəˈlɑpəθi
old=oʊld
tight=taɪt
myelography=ˌmaɪəˈlɑɡrəfi
metal=ˈmɛd(ə)l
reconversion=ˌrikənˈvərʒ(ə)n
tangent=ˈtændʒənt
cage=keɪdʒ
pulpous=ˈpəlpəs
column=ˈkɑləm
terminalia=ˌtərməˈneɪljə
whiplash=ˈ(h)wɪpˌlæʃ
growth=ɡroʊθ
artificial=ˌɑrdəˈfɪʃ(ə)l
immature=ˌɪməˈtʊ(ə)r
capn=ˈkæpn
pachymeningitis=ˌpækiˌmɛnənˈdʒaɪdᵻs
above=əˈbəv
caudal=ˈkɔd(ə)l
neuron=ˈn(j)ʊˌrɑn
aesthesis=ˌɛsˈθisᵻs
belt=bɛlt
achondroplastic=ˌeɪˌkɑndrəˈplæstɪk
senile=ˈsiˌnaɪl
island=ˈaɪlənd
history=ˈhɪst(ə)ri
protrude=prəˈtrud
tunnel=ˈtən(ə)l
brics=brɪks
disuse=dɪsˈjuːs
kummel=ˈkʊməl
plexi=ˈplɛksi
cement=səˈmɛnt
harlot=ˈhɑrlət
distraction=dəˈstrækʃən
condensate=kənˈdɛnˌseɪt
vai=vaɪ
arabinoside=əˈræbənəˌsaɪd
hinayana=ˌhɪnəˈjɑnə
interarticular=ˌɪntərɑːˈtɪkjuːlə
split=splɪt
osteolysis=ˌɑstiˈɑləsəs
premature=ˌpriməˈtʃər
sclerotic=sklɪəˈrɒtɪk
opal=ˈoʊp(ə)l
spondylolisthesis=ˌspɒndɪləʊlɪsˈθiːsɪs
articulation=ɑrˌtɪkjəˈleɪʃən
erythropoiesis=ɛˌrɪθrəʊpɔɪˈiːsɪs
monro=mənˈroʊ
cyanosis=sʌɪəˈnəʊsɪs
agenesic=ˌeɪdʒəˈnizɪk
rudimentary=ˌrudəˈmɛn(t)əri
overgrowth=ˈoʊvərˌɡroʊθ
enzyme=ˈɛnˌzaɪm
drown=draʊn
paragonimiasis=ˌpɛrəˌɡoʊnəˈmaɪəsəs
ectophytic=ˌɛktəˈfɪdɪk
polydactyly=ˌpɑliˈdæktəli
batter=ˈbædər
sleep=slip
bal=bæl
epidermal=ˌɛpəˈdərm(ə)l
handicap=ˈhændiˌkæp
infant=ˈɪnfənt
semialdehyde=ˌsɛˌmaɪˈældəˌhaɪd
bald=bɔld
pedes=ˈpɛdiz
malnutrition=ˌmæln(j)uˈtrɪʃən
myelogenous=ˌmaɪəˈlɑdʒənəs
crash=kræʃ
trichinosis=trɪkɪˈnəʊsɪs
hydromyelia=ˌhaɪdroʊˌmaɪˈiliə
neurohypophysis=ˌn(j)ʊroʊˌhaɪˈpɑfəsəs
sutural=ˈsjuːtjʊərəl
strabismus=strəˈbɪzməs
pay=peɪ
blush=bləʃ
synkinesis=ˌsɪnkəˈnisᵻs
postcerebellar=ˌpoʊs(t)ˌsɛrəˈbɛlər
laxity=ˈlæksədi
succinate=ˈsʌksɪneɪt
intellectual=ˌɪn(t)əˈlɛk(t)ʃ(əw)əl
stigma=ˈstɪɡmə
lissencephalous=ˌlɪsɛnˈsɛfələs
warburg=ˈwɔrˌbərɡ
rale=rɑl
proper=ˈprɑpər
dysphagia=dɪsˈfeɪdʒɪə
sparganosis=ˌspɑrɡəˈnoʊsəs
macrocephaly=ˌmækroʊˈsɛfəli
extra-natural=ˌɛkstrəˈnætʃər(ə)l
correlate=ˈkɔrəˌleɪt
quadrupedal=ˌkwɑdrəˈpɛd(ə)l
intra-ocular=ɪntrəˈɒkjʊlə
cyberland=ˈsaɪbərˌlænd
enteric=ɛnˈtɛrɪk
isocaloric=ˌaɪsoʊkəˈlɔrɪk
pellucid=pəˈlusəd
astrocytic=ˌæstrəˈsɪdɪk
slit=slɪt
stupefactive=ˌst(j)upəˈfæktɪv
periocular=ˌpɛriˈɑkjələr
orthopaedic=ˌɔrθəˈpidɪk
caam=kɑːm
metabolism=məˈtæbəˌlɪzəm
pre-eclampsia=ˌpriɪˈklæm(p)siə
reticulocytosis=rəˌtɪkjələsaɪˈtoʊsəs
sulfatide=ˈsʌlfətaɪd
brittle=ˈbrɪd(ə)l
finding=ˈfaɪndɪŋ
diplegia=dʌɪˈpliːdʒɪə
arbovirus=ˈɑrboʊˌvaɪrəs
sudden=ˈsəd(ə)n
overhunting=ˌoʊvərˈhən(t)ɪŋ
painful=ˈpeɪnf(ə)l
asphyxia=asˈfɪksɪə
link=lɪŋk
velum=ˈviləm
panophthalmia=ˌpænɑpˈθælmiə
elevate=ˈɛləˌveɪt
meaning=ˈminɪŋ
myelocele=ˈmaɪəloʊˌsil
myelination=ˌmaɪələˈneɪʃən
disorganized=dɪsˈɔrɡəˌnaɪzd
bong=bɑŋ
commissural=kəˈmɪʃʊrəl
frontality=ˌfrənˈtælədi
methylmalonic=ˌmɛθəlməˈloʊnɪk
puffy=ˈpəfi
prenatal=priˈneɪdl
probosces=proʊˈbɑˌsiz
valley=ˈvæli
ri=ri
cynocephalus=sʌɪnəʊˈsɛfələs
abnormally=æbˈnɔrməli
macular=ˈmækjələr
limb=lɪm
birth=bərθ
cingulate=ˈsɪŋɡjuːlət
hyperinsulinaemia=ˌhaɪpərˌɪn(t)sələˈnimiə
cyclopia=sʌɪˈkləʊpɪə
gen-z=ˌdʒɛn ˈzi
vav=vav
enhance=ᵻnˈhæn(t)s
size=saɪz
monotype=ˈmɑnəˌtaɪp
alloimmune=ˌæloʊəˈmjun
allons=æˈlɔn
choriomeningitis=ˌkɔrioʊˌmɛnənˈdʒaɪdᵻs
lowe=laʊ
severely=səˈvɪrli
cosmetic=kɑzˈmɛdɪk
litch=lɪtʃ
hypoventilation=ˌhaɪpoʊˌvɛn(t)əˈleɪʃən
intra-orbital=ˌɪntrəˈɔrbəd(ə)l
pigment=ˈpɪɡm(ə)nt
faki=ˈfæki
padlike=ˈpædˌlaɪk
sida=ˈsʌɪdə
hepatomegaly=ˌhɛpədoʊˈmɛɡəli
cervid=ˈsəːvɪd
intermedium=ɪntəˈmiːdɪəm
funnel=ˈfən(ə)l
lake=leɪk
microphthalmia=ˌmaɪkrɑpˈθælmiə
intragluteal=ˌɪntrəˈɡludiəl
nystagmus=naɪˈstæɡməs
constipation=ˌkɑn(t)stəˈpeɪʃən
resolve=rəˈzɔlv
intracerebral=ˌɪntrəsəˈribrəl
biogenesis=ˌbaɪoʊˈdʒɛnəsəs
methyltransferase=ˌmɛθəlˈtræn(t)sfəˌreɪz
heterochromia=ˌhɛdəroʊˈkroʊmiə
otocyst=ˈoʊdəˌsɪst
position=pəˈzɪʃən
sciatica=saɪˈædəkə
non-compliant=ˌnɑnkəmˈplaɪ(ə)nt
anal=ˈeɪn(ə)l
neurodegenerative=ˌn(j)ʊroʊdəˈdʒɛnərədɪv
compressive=kəmˈprɛsɪv
radiologically=ˌreɪdiəˈlɑdʒək(ə)li
ketosis=kiˈtoʊsəs
shift=ʃɪft
rabies=ˈreɪbiz
leucine=ˈlusən
convocational=kɒnvəʊˈkeɪʃənəl
pes=piz
subpial=ˌsəbˈpiəl
attack=əˈtæk
ncis=ˈɛn(t)sɪs
globoid=ˈɡloʊˌbɔɪd
ataxic=əˈtæksɪk
attenuate=əˈtɛnjəˌweɪt
pringle=ˈprɪŋɡ(ə)l
slow-food=ˌsloʊ ˈfud
young=jəŋ
toxicity=tɑkˈsɪsədi
varicella=ˌvɛrəˈsɛlə
paraparesis=ˌpɛrəpəˈrisᵻs
retro-ocular=ˌrɛtroʊˈɑkjələr
mortier=ˌmɔrdiˈeɪ
pott=pɑt
acidaemia=ˌæsəˈdimiə
scheme=skim
spasticity=spæˈstɪsᵻdi
evolve=əˈvɔlv
headache=ˈhɛdˌeɪk
enucleation=ɪˌnjuːklɪˈeɪʃən
curarine=ˈkjʊərərʌɪn
marking=ˈmɑrkɪŋ
impairment=ɪmˈpɛrmənt
stalk=stɔk
trypanosomiasis=ˌtrɪpənəʊsəˈmaɪəsɪs
transplantation=ˌtræn(t)sˌplænˈteɪʃən
steady-state=ˌstɛdi ˈsteɪt
sprengel=ˈʃprɛŋəl
hypoglycaemic=ˌhaɪpoʊˌɡlaɪˈsimɪk
cranium=ˈkreɪnɪəm
apnoea=ˈæpniə
communicate=kəˈmjunəˌkeɪt
japanese=ˌdʒæpəˈniz
lordosis=lɔrˈdoʊsəs
meningism=məˈnɪn(d)ʒɪzəm
fontanelle=ˌfɑntnˈɛl
lipoidosis=lɪpɔɪˈdəʊsɪs
accident=ˈæksədnt
cid=sɪd
detant=dɪˈtant
intrapelvic=ˌɪntrəˈpɛlvɪk
tetraparesis=ˌtɛtrəpəˈrisᵻs
retrogressive=ˌrɛtrəˈɡrɛsɪv
volume=ˈvɑljəm
spastic=ˈspæstɪk
thrombose=ˈθrɑmˌboʊs
galenic=ɡeɪˈlɛnɪk
ape=eɪp
teenager=ˈtiˌneɪdʒər
lese=liz
dehydrogenase=ˌdiˌhaɪˈdrɑdʒəˌneɪz
choriocarcinoma=ˌkɔrioʊˌkɑrsəˈnoʊmə
talipes=ˈtalɪpiːz
villous=ˈvɪləs
fibrinoid=ˈfaɪbrəˌnɔɪd
dime=daɪm
neuropil=ˈn(j)ʊrəˌpɪl
porencephaly=ˌpɔrɛnˈsɛfəli
vacuolating=ˈvakjuːəleɪtɪŋ
racemose=ˈræsəˌmoʊs
zoster=ˈzɑstər
dysmenorrhoea=ˌdɪsmɛnəˈriːə
sensation=sɛnˈseɪʃən
accidental=ˌæksəˈdɛn(t)l
mt=ˌɛmˈti
seed=sid
dyspareunia=ˌdɪspəˈruniə
gowa=ˈɡoʊwə
nance=næn(t)s
abundant=əˈbənd(ə)nt
carus=ˈkɛːrəs
insidious=ᵻnˈsɪdiəs
prodrome=ˈproʊˌdroʊm
hands-off=ˌhændz ˈɔf
dysarthria=dɪˈsɑrθriə
autism=ˈɔˌtɪzəm
multilayered=ˌməltiˈleɪərd
expand=ɪkˈspænd
laminar=ˈlæmənər
prior=ˈpraɪ(ə)r
nd=ˌɛnˈdi
sly=slaɪ
murray=ˈməri
diabetes=ˌdaɪəˈbidiz
eastern=ˈistərn
locomotion=ˌloʊkəˈmoʊʃən
fuse=fjuz
triad=ˈtraɪˌæd
pro=proʊ
ping=pɪŋ
hyaluronidase=ˌhʌɪəljʊˈrɒnɪdeɪz
phenylketonuria=ˌfɛnəlˌkitnˈ(j)ʊriə
sod=sɑd
flatten=ˈflætn
meningoencephalitis=məˌnɪŋɡoʊᵻnˌsɛfəˈlaɪdᵻs
error=ˈɛrər
debilitate=dəˈbɪləˌteɪt
chronically=ˈkrɑnək(ə)li
inequality=ˌɪniˈkwɑlədi
mimicking=ˈmɪmɪkɪŋ
slowly=ˈsloʊli
cree=kri
precession=prəˈsɛʃən
scleral=ˈsklɛrəl
cerebrum=ˈsɛrɪbrəm
schiller=ˈʃɪlər
calla=ˈkælə
multicultural=ˌməltiˈkəl(t)ʃ(ə)r(ə)l
parietal=pəˈraɪəd(ə)l
chiasmatic=kʌɪazˈmatɪk
canalization=ˌkænələˈzeɪʃən
else=ɛls
fish-man=ˈfɪʃ ˌmæn
hetero-axial=ˌhɛdəroʊˈæksiəl
hemiparesis=ˌhɛməpəˈrisᵻs
periorbital=ˌpɛriˈɔrbəd(ə)l
maud=mɔd
mega=ˈmɛɡə
dorsally=ˈdɔrsəli
paresis=pəˈrisᵻs
urinary=ˈjʊrəˌnɛri
collection=kəˈlɛkʃən
sulcation=sʌlˈkeɪʃən
adjective=ˌʃɔrt ˈrən
trilateral=trʌɪˈlatərəl
van=væn
quadriplegia=ˌkwɑdrəˈpli(d)ʒə
thrombocytopenia=ˌθrɑmbəˌsaɪdəˈpiniə
notochord=ˈnoʊdəˌkɔrd
cutaneous=kjuˈteɪniəs
cobblestone=ˈkɑb(ə)lˌstoʊn
incontinently=ᵻnˈkɑn(t)(ə)nəntli
acene=ˈeɪsin
gyral=ˈdʒʌɪərəl
kyphoscoliosis=ˌkaɪfoʊˌskoʊliˈoʊsəs
ecchymosis=ɛkɪˈməʊsɪs
proptosis=prɑpˈtoʊsəs
laceration=ˌlæsəˈreɪʃən
rosette=roʊˈzɛt
globus=ˈɡloʊbəs
mew=mju
ectopia=ɛkˈtoʊpiə
maturation=ˌmætʃəˈreɪʃən
organ=ˈɔrɡ(ə)n
haemopoietic=ˌhiməˌpɔɪˈɛdɪk
cutis=ˈkjudəs
cisterna=sɪˈstəːnə
ipid=ˈɪpɪd
paralytic=ˌpɛrəˈlɪdɪk
cryptococcal=ˌkrɪptəˈkɑk(ə)l
slept=slɛpt
bilirubin=ˈbɪliˌrubən
infundibular=ɪnfʌnˈdɪbjʊlə
proteus=ˈproʊdiəs
short=ʃɔrt
endosteal=ɛnˈdɑstiəl
hemisphere=ˈhɛməˌsfɪ(ə)r
postnatal=ˌpoʊs(t)ˈneɪdl
hantavirus=ˈhæn(t)əˌvaɪrəs
vergee=ˈvɛːʒeɪ
ptosis=ˈtoʊsəs
rett=rɛt
micronodular=ˌmaɪkroʊˈnɑdʒələr
alter=ˈɔltər
iridic=ʌɪˈrɪdɪk
dyspnoea=dɪspˈniə
chorea=kɒˈriːə
hypermobility=ˌhaɪpərˌmoʊˈbɪlᵻdi
cow=kaʊ
postictal=ˌpoʊstˈɪkt(ə)l
seller=ˈsɛlər
lip=lɪp
simplify=ˈsɪmpləˌfaɪ
dysphonia=dɪsˈfoʊniə
mould=moʊld
rubeosis=rubiˈoʊsəs
horn=hɔrn
turn=tərn
depress=dəˈprɛs
panhypopituitarism=ˌpænˌhaɪpoʊpəˈt(j)uədəˌrɪzəm
transection=trɑːnˈsɛkʃən
cephalhaematoma=ˌsɛf(ə)lˌhiməˈtoʊmə
lethargy=ˈlɛθərdʒi
bias=ˈbaɪəs
hypotonia=hʌɪpəʊˈtəʊnɪə
proboscis=proʊˈbɑsəs
masa=ˈmɑsə
knap=næp
peripartum=ˌpɛrəˈpɑrdəm
anisocoria=-ˈkɒrɪə
der=dər
hippocampal=ˌhɪpəˈkæmp(ə)l
destruction=dəˈstrəkʃən
propionic=ˌproʊpiˈɑnɪk
pallidum=ˈpæləd(ə)m
pancytopenia=ˌpænˌsaɪdəˈpiniə
proliferate=prəˈlɪfəˌreɪt
myelin=ˈmaɪəl(ə)n
batten=ˈbat(ə)n
bind=baɪnd
acrania=eɪˈkreɪniə
adaptive=əˈdæptɪv
lack=læk
vermian=ˈvərmiən
cassab=kəˈsɑːb
convulsion=kənˈvəlʃən
heterogenous=ˌhɛdəˈrɑdʒənəs
peripapillary=ˌpɛrəˈpæpəˌlɛri
ssd=ˌɛsɛsˈdi
gargoylism=ˈɡɑrˌɡɔɪˌlɪzəm
epiloia=ɛpɪˈlɔɪə
mutation=mjuˈteɪʃən
neuropile=ˈn(j)ʊrəˌpaɪl
vanish=ˈvænɪʃ
maternally=məˈtərnl̩i
hypertelorism=ˌhaɪpərˈtɛləˌrɪzəm
incidental=ˌɪn(t)səˈdɛn(t)l
macrocranial=ˌmækrəˈkreɪniəl
ptoses=ˈtoʊsiz
dystonia=dɪˈstəʊnɪə
hepatosplenomegaly=ˌhɛpədoʊˌsplɛnoʊˈmɛɡəli
phocomelia=ˌfoʊkoʊˈmiliə
louis=ˈluəs
ava=ˈɑːvə
cardiothoracic=ˌkɑrdioʊθəˈræsɪk
menkes=ˈmɛŋkəz
neurologic=ˌn(j)ʊrəˈlɑdʒɪk
nipa=ˈnipə
superinfection=ˌsupərᵻnˈfɛkʃən
inborn=ˌɪnˈbɔrn
fraction=ˈfrækʃən
suicide=ˈsuəˌsaɪd
airplane=ˈɛrˌpleɪn
booking=ˈbʊkɪŋ
testimonial=ˌtɛstəˈmoʊniəl
county=ˈkaʊn(t)i
gap=ɡæp
previous=ˈpriviəs
innovation=ˌɪnəˈveɪʃən
imagination=ᵻˌmædʒəˈneɪʃən
operation=ˌɑpəˈreɪʃən
e-day=ˈiˌdeɪ
departmental=dəˌpɑrtˈmɛn(t)l
welcome=ˈwɛlkəm
sayst=seɪst
lone=loʊn
bbc=ˌbiˌbiˈsi
zambian=ˈzæmbiən
reprint=riˈprɪnt
emerge=əˈmərdʒ
philadelphia=ˌfɪləˈdɛlfiə
tuner=ˈt(j)unər
accountability=əˌkaʊn(t)əˈbɪlədi
welsh=wɛlʃ
truck=trək
minister=ˈmɪnəstər
volleyball=ˈvɑliˌbɔl
starter=ˈstɑrdər
necessity=nəˈsɛsədi
sacred=ˈseɪkrᵻd
mit=mɪt
forgotten=fərˈɡɑtn
pick=pɪk
sofa=ˈsoʊfə
engagement=ɑ̃ˈɡæʒmɑ̃
shall=ʃæl
emotional=əˈmoʊʃ(ə)nəl
illness=ˈɪlnəs
spare=spɛ(ə)r
pennsylvania=ˌpɛn(t)səlˈveɪnjə
suffer=ˈsəfər
demographic=ˌdɛməˈɡræfɪk
hispanic=hɪˈspænɪk
sand=sænd
enjoy=ᵻnˈdʒɔɪ
eternal=əˈtərn(ə)l
webmaster=ˈwɛbˌmæstər
statewide=ˈsteɪtˌwaɪd
purple=ˈpərp(ə)l
retailer=ˈriˌteɪlər
dominican=dəˈmɪnəkən
bottle=ˈbɑdəl
cure=kjʊ(ə)r
whereas=(h)wəˈræz
timer=ˈtaɪmər
wonder=ˈwəndər
payday=ˈpeɪˌdeɪ
odd=ɑd
cricket=ˈkrɪkɪt
project=prəˈdʒɛk(t)
empire=ˈɛmˌpaɪ(ə)r
aviation=ˌeɪviˈeɪʃən
amount=əˈmaʊnt
reliable=rəˈlaɪəb(ə)l
rebel=ˈrɛb(ə)l
herb=(h)ərb
rat=ræt
gender=ˈdʒɛndər
dramatic=drəˈmædɪk
quantitative=ˈkwɑn(t)əˌteɪdɪv
analyst=ˈænələst
wine=waɪn
john=dʒɑn
revelation=ˌrɛvəˈleɪʃən
autobio=ˌɔdəˈbaɪoʊ
header=ˈhɛdər
workstation=ˈwərkˌsteɪʃən
nancy=ˈnæn(t)si
explosion=ᵻkˈsploʊʒ(ə)n
mortality=mɔrˈtælədi
francisca=frænˈsɪskə
seventh=ˈsɛvənθ
pen=pɛn
carley=ˈkɑːli
afford=əˈfɔrd
allah=ˈɑlə
grain=ɡreɪn
actually=ˈæk(t)ʃ(əw)əli
spanish=ˈspænɪʃ
disable=dəˈseɪb(ə)l
kingdom=ˈkɪŋdəm
charleston=ˈtʃɑrlstən
awa=əˈweɪ
release=rəˈlis
sandia=sanˈdia
firm=fərm
speech=spitʃ
dear=dɪ(ə)r
unnecessary=ˌənˈnɛsəˌsɛri
equilibrium=ˌɛkwəˈlɪbriəm
bunny=ˈbəni
reynolds=ˈrɛnəl(d)z
compare=kəmˈpɛ(ə)r
coleman=ˈkoʊlm(ə)n
tremble=ˈtrɛmb(ə)l
compound=ˈkɑmˌpaʊnd
designation=ˌdɛzɪɡˈneɪʃən
pendant=ˈpɛnd(ə)nt
mere=mɪ(ə)r
comment=ˈkɑˌmɛnt
miami=ˌmaɪˈæmi
beautiful=ˈbjudəfəl
loose=lus
mobile=ˈmoʊbəleɪ
rather=ˈræðər
guestbook=ˈɡɛstbʊk
stafford=ˈstæfərd
posting=ˈpoʊstɪŋ
flexible=ˈflɛksəb(ə)l
illinois=ˌɪləˈnɔɪ
perry=ˈpɛri
happen=ˈhæpən
parish=ˈpɛrɪʃ
preview=ˈpriˌvju
compilation=ˌkɑmpəˈleɪʃən
israeli=ᵻzˈreɪli
kick=kɪk
paso=ˈpɑsoʊ
remove=rəˈmuv
exploration=ˌɛkspləˈreɪʃən
clare=klɛ(ə)r
naples=ˈneɪp(ə)lz
twenty=ˈtwɛn(t)i
search=sərtʃ
couldst=kʊdst
arctic=ˈɑrktɪk
imagine=ᵻˈmædʒən
typically=ˈtɪpᵻk(ə)li
hazardous=ˈhæzərdəs
price=praɪs
poll=poʊl
tank=tæŋk
possession=pəˈzɛʃən
buck=bək
immigration=ˌɪməˈɡreɪʃən
confix=kənˈfɪks
employee=əmˌplɔ(ɪ)ˈi
respond=rəˈspɑnd
mcdonalds=məkˈdɑnəl(d)z
dem=dɛm
violin=ˌvaɪəˈlɪn
suburban=səˈbərbən
wichita=ˈwɪtʃəˌtɔ
feat=fit
pennies=ˈpɛniz
federation=ˌfɛdəˈreɪʃən
hat=hæt
partnership=ˈpɑrtnərˌʃɪp
convertible=kənˈvərdəb(ə)l
hereby=ˈhɪrˌbaɪ
desire=dəˈzaɪ(ə)r
secretariat=ˌsɛkrəˈtɛriət
sheriff=ˈʃɛrəf
mailed=meɪld
weekly=ˈwikli
homework=ˈhoʊmˌwərk
threshold=ˈθrɛʃˌ(h)oʊld
moniker=ˈmɑnəkər
night=naɪt
e-shop=ˈiˌʃɑp
resume=rəˈz(j)um
yarn=jɑrn
module=ˈmɑdʒul
hollywood=ˈhɑliˌwʊd
direction=dəˈrɛkʃən
tiny=ˈtaɪni
contain=kənˈteɪn
python=ˈpaɪˌθɑn
chassis=ˈtʃæsi
competitive=kəmˈpɛdədɪv
tune=t(j)un
rage=reɪdʒ
forever=fəˈrɛvər
gig=ɡɪɡ
mount=maʊnt
various=ˈvɛriəs
sexual=ˈsɛkʃ(əw)əl
robinson=ˈrɑbəns(ə)n
eden=ˈid(ə)n
felt=fɛlt
thereby=ðɛrˈbaɪ
federal=ˈfɛd(ə)rəl
real=ri(ə)l
rouge=ruʒ
view=vju
chad=tʃæd
independent=ˌɪndəˈpɛndənt
vat=ˌviˌeɪˈti
gain=ɡeɪn
vinyl=ˈvaɪn(ə)l
manitoban=ˌmænəˈtoʊbən
organizational=ˌɔrɡənəˈzeɪʃən(ə)l
trace=treɪs
care=kɛ(ə)r
gross=ɡroʊs
cliff=klɪf
verse=vərs
hun=hən
guard=ɡɑrd
engine=ˈɛndʒən
chief=tʃif
titanium=təˈteɪniəm
widescreen=ˌwaɪdˈskrin
entire=ənˈtaɪ(ə)r
pair=pɛ(ə)r
moment=ˈmoʊm(ə)nt
dodge=dɑdʒ
stainless=ˈsteɪnlᵻs
action=ˈækʃən
mae=mɛ
maine=meɪn
obviously=ˈɑbviəsli
sweet=swit
vice=vaɪs
ranger=ˈreɪndʒər
whenever=(h)wəˈnɛvər
adventure=ədˈvɛn(t)ʃər
yale=jeɪl
luggage=ˈləɡɪdʒ
thumbnail=ˈθəmˌneɪl
hundi=ˈhʊndi
citation=saɪˈteɪʃən
fario=ˈfɛːrɪəʊ
independence=ˌɪndəˈpɛnd(ə)n(t)s
subjective=səbˈdʒɛktɪv
encounter=ᵻnˈkaʊn(t)ər
involve=ᵻnˈvɑlv
stun=stən
threaten=ˈθrɛtn
fabric=ˈfæbrɪk
reggae=ˈrɛɡeɪ
none=nən
coffee=ˈkɔfi
compiler=kəmˈpaɪlər
toner=ˈtoʊnər
temporarily=ˈtɛmpəˌrɛrəli
manual=ˈmænjə(wə)l
flyer=ˈflaɪər
confidentiality=ˌkɑnfəˌdɛn(t)ʃiˈælədi
beneath=bəˈniθ
denial=dəˈnaɪ(ə)l
biblical=ˈbɪblᵻk(ə)l
minorca=məˈnɔrkə
consecutive=kənˈsɛkjədɪv
scenario=səˈnɛrioʊ
portland=ˈpɔrtlən(d)
comic=ˈkɑmɪk
hay=heɪ
aymara=ˌʌɪməˈrɑː
won't=woʊnt
kitchen=ˈkɪtʃ(ə)n
accordance=əˈkɔrdn(t)s
downloadable=ˌdaʊnˈloʊdəbəl
europe=ˈjərəp
qualification=ˌkwɑləfəˈkeɪʃən
certification=ˌsərdəfəˈkeɪʃən
recreational=ˌrɛkriˈeɪʃ(ə)nəl
lender=ˈlɛndər
brik=brik
belief=bəˈlif
gourmet=ˈɡʊrˌmeɪ
downtown=ˌdaʊnˈtaʊn
somalian=səˈmɑliən
final=ˈfaɪn(ə)l
ireland=ˈaɪrlən(d)
guide=ɡaɪd
corruption=kəˈrəpʃən
slovak=ˈsloʊˌvɑk
lindau=ˈlɪndaʊ
flex=flɛks
pretty=ˈprɪdi
gold=ɡoʊld
instruction=ᵻnˈstrəkʃən
uruguayan=ˌ(j)ʊrəˈɡwaɪən
among=əˈməŋ
ax=æks
granny=ˈɡræni
ongoing=ˈɔnˌɡoʊɪŋ
horse=hɔrs
pert=pərt
journalist=ˈdʒərnl̩əst
palm=pɑ(l)m
edward=ˈɛdwərd
boost=bust
prot=prɑt
sticker=ˈstɪkər
qualify=ˈkwɑləˌfaɪ
usage=ˈjusɪdʒ
solely=ˈsoʊ(l)li
couple=ˈkəp(ə)l
transmit=trænzˈmɪt
memorial=məˈmɔriəl
constraint=kənˈstreɪnt
controversial=ˌkɑntrəˈvərsiəl
spray=spreɪ
customer=ˈkəstəmər
guyanan=ɡiˈænən
magnet=ˈmæɡnət
salon=səˈlɑn
thoroughly=ˈθərəli
inexpensive=ˌɪnɪkˈspɛn(t)sɪv
annually=ˈænj(əw)əli
araba=əˈrɑbə
norman=ˈnɔrm(ə)n
surf=sərf
once=wəns
morrison=ˈmɔrəs(ə)n
vincent=ˈvɪn(t)s(ə)nt
enough=ᵻˈnəf
convenient=kənˈvinjənt
senegal=ˈsɛnɪɡɔːl
console=ˈkɑnˌsoʊl
currently=ˈkərəntli
lace=leɪs
intro=ˈɪntroʊ
equator=əˈkweɪdər
lucky=ˈləki
jesus=ˈdʒizəs
voluntary=ˈvɑlənˌtɛri
quarter=ˈkwɔrdər
diff=dɪf
bread=brɛd
conviction=kənˈvɪkʃən
needn't=ˈnidnt
medicaid=ˈmɛdəˌkeɪd
pix=pɪks
event=əˈvɛnt
available=əˈveɪləb(ə)l
euro=ˈjəroʊ
confidence=ˈkɑnfəd(ə)n(t)s
hugo=ˈ(h)juɡoʊ
loan=loʊn
ton=tən
opinion=əˈpɪnj(ə)n
tour=ˈtaʊər
duty=ˈd(j)udi
thunder=ˈθəndər
attention=əˈtɛn(t)ʃən
contribute=kənˈtrɪbjut
stud=stəd
dome=doʊm
jean=dʒin
pub=pəb
any=ˈɛni
able=ˈeɪb(ə)l
tennessee=tɛnəˈsiː
cond=kʌnd
kitty=ˈkɪdi
panama=ˈpænəˌmɑ
indirect=ˌɪndəˈrɛk(t)
new-left=ˌn(j)u ˈlɛft
notification=ˌnoʊdəfəˈkeɪʃən
work=wərk
benjamin=ˈbɛndʒəmɪn
bureaus=ˈbjʊroʊz
wright=raɪt
terrain=təˈreɪn
willow=ˈwɪloʊ
mentor=ˈmɛnˌtɔr
mathematical=ˌmæθ(ə)ˈmædək(ə)l
theology=θiˈɑlədʒi
themselves=ðəmˈsɛlvz
entrance=ˈɛntrən(t)s
las=lɑːs
industrial=ᵻnˈdəstriəl
genet=ˈdʒɛnət
tap=tæp
courteous=ˈkərdiəs
generate=ˈdʒɛnəˌreɪt
trinodal=trʌɪˈnəʊdəl
defensive=dəˈfɛn(t)sɪv
strength=strɛŋ(k)θ
wherever=(h)wəˈrɛvər
officer=ˈɔfəsər
partner=ˈpɑrtnər
helpful=ˈhɛlpf(ə)l
potentially=pəˈtɛn(t)ʃəli
much=mətʃ
bred=brɛd
slight=slaɪt
formal=ˈfɔrm(ə)l
rental=ˈrɛn(t)l
auspex=ˈɔːspɛks
radius=ˈreɪdiəs
definitely=ˈdɛf(ə)nətli
undo=ˌənˈdu
inca=ˈɪŋkə
ultimate=ˈəltəmət
appraisal=əˈpreɪz(ə)l
pharmacy=ˈfɑrməsi
regulation=ˌrɛɡ(j)əˈleɪʃən
relative=ˈrɛlədɪv
notebook=ˈnoʊtˌbʊk
restrict=rəˈstrɪk(t)
commissioner=kəˈmɪʃ(ə)nər
beneficial=ˌbɛnəˈfɪʃ(ə)l
knowledge=ˈnɑlədʒ
correction=kəˈrɛkʃən
undefined=ˌəndəˈfaɪnd
spain=speɪn
equity=ˈɛkwədi
diverse=dəˈvərs
cemetery=ˈsɛməˌtɛri
annex=æˈnɛks
remedy=ˈrɛmədi
snow=snoʊ
consultancy=kənˈsəltn(t)si
sap=sæp
limousine=ˈlɪməˌzin
twist=twɪst
japan=dʒəˈpæn
collector=kəˈlɛktər
exclusively=ɪkˈsklusəvli
infrastructure=ˈɪnfrəˌstrək(t)ʃər
potential=pəˈtɛn(t)ʃ(ə)l
def=dɛf
da=dɑ
extraordinary=ɪkˈstrɔrdnˌɛri
seem=sim
fantastic=fænˈtæstɪk
sufficiently=səˈfɪʃən(t)li
rope=roʊp
sum=səm
toyo=ˈtɔɪoʊ
horizon=həˈraɪz(ə)n
pureed=pjʊˈreɪd
lounge=laʊndʒ
expiration=ˌɛkspəˈreɪʃən
until=ˌənˈtɪl
kyle=kaɪl
set=sɛt
prophet=ˈprɑfət
incredible=ᵻnˈkrɛdəb(ə)l
restriction=rəˈstrɪkʃən
ceremony=ˈsɛrəˌmoʊni
alabama=ˌæləˈbæmə
outside=ˌaʊtˈsaɪd
differ=ˈdɪfər
licence=ˈlaɪsn(t)s
slide-show=ˈslaɪd ˌʃoʊ
telecommunication=ˌtɛləkəˌmjunəˈkeɪʃən
front=frənt
harvey=ˈhɑrvi
macro=ˈmækroʊ
raise=reɪz
spotlight=ˈspɑtˌlaɪt
importance=ᵻmˈpɔrtn(t)s
contract=ˈkɑnˌtræk(t)
especially=əsˈpɛʃəli
photographer=fəˈtɑɡrəfər
sorry=ˈsɔri
logistic=ləˈdʒɪstɪk
careful=ˈkɛrf(ə)l
personal=ˈpərs(ə)nəl
proc=prɑk
frame=freɪm
mate=meɪt
benchmark=ˈbɛn(t)ʃˌmɑrk
additional=əˈdɪʃənl
graham=ɡræm
drain=dreɪn
forty=ˈfɔrdi
diamond=ˈdaɪ(ə)mən(d)
promo=ˈproʊˌmoʊ
areola=ˌɛriˈoʊlə
democracy=dᵻˈmɑkrəsi
generally=ˈdʒɛn(ə)rəli
everyday=ˈɛvriˌdeɪ
unity=ˈjunədi
parade=pəˈreɪd
suspend=səˈspɛnd
universal=ˌjunəˈvərs(ə)l
essence=ˈɛs(ə)n(t)s
prisoner=ˈprɪznər
realistic=ˌriəˈlɪstɪk
dust=dəst
suspension=səˈspɛn(t)ʃ(ə)n
encode=ᵻnˈkoʊd
terrace=ˈtɛrəs
technology=tɛkˈnɑlədʒi
additionally=əˈdɪʃ(ə)nəli
advertise=ˈædvərˌtaɪz
res=reɪs
dim=dɪm
dover=ˈdoʊvər
appoint=əˈpɔɪnt
guild=ɡɪld
cunt=kənt
hire=ˈhaɪ(ə)r
refinance=ˌrifəˈnæn(t)s
subsidiary=səbˈsɪdiˌɛri
dt=ˈdiːˈtiː
done=dən
fund=fənd
eligible=ˈɛlədʒəb(ə)l
inclusive=ᵻnˈklusɪv
economy=iˈkɑnəmi
writer=ˈraɪdər
server=ˈsərvər
dame=deɪm
modular=ˈmɑdʒələr
applicant=ˈæplək(ə)nt
bradford=ˈbrædfərd
script=skrɪp(t)
police=pəˈlis
rack=ræk
naughty=ˈnɔdi
latex=ˈleɪˌtɛks
gulf=ɡəlf
south=saʊθ
subscription=səbˈskrɪpʃən
craft=kræft
spam=spæm
gel=dʒɛl
blank=blæŋk
exact=ɪɡˈzæk(t)
ordinance=ˈɔrd(ə)nən(t)s
coll=kɔl
objective=əbˈdʒɛktɪv
humanitarian=hjuˌmænəˈtɛriən
prompt=prɑm(p)t
photographic=ˌfoʊdəˈɡræfɪk
proceeding=prəˈsidɪŋ
ferry=ˈfɛri
buse=bjuz
uncle=ˈəŋkəl
import=ˈɪmˌpɔrt
tom=tɑm
exchange=ɪksˈtʃeɪndʒ
app=æp
punk=pəŋk
through=θru
comparative=kəmˈpɛrədɪv
run=rən
netherlander=ˈnɛðərˌlændər
pref=prɛf
vocational=voʊˈkeɪʃ(ə)nəl
undergraduate=ˌəndərˈɡrædʒəwət
hunger=ˈhəŋɡər
aim=eɪm
incoming=ˈɪnˌkəmɪŋ
troy=trɔɪ
residence=ˈrɛz(ə)d(ə)n(t)s
jeff=dʒɛf
intense=ᵻnˈtɛn(t)s
banner=ˈbænər
annotate=ˈænəˌteɪt
download=ˈdaʊnˌloʊd
harbour=ˈhɑrbər
appreciation=əˌpriʃiˈeɪʃən
multi=ˈməlti
past=pæst
tractor=ˈtræktər
architecture=ˈɑrkəˌtɛk(t)ʃər
arrive=əˈraɪv
incest=ˈɪnˌsɛst
oregon=ˈɔrəˌɡɑn
silly=ˈsɪli
scout=skaʊt
spouse=spaʊs
congratulation=kənˌɡratjʊˈleɪʃən
ohio=oʊˈhaɪoʊ
aggregate=ˈæɡrəɡət
cash=kæʃ
marriage=ˈmɛrɪdʒ
pauillac=pɔɪˈ(j)ɑk
alive=əˈlaɪv
orchestra=ˈɔrkəstrə
Alani=əˈlɑni
sunshine=ˈsənˌʃaɪn
peterson=ˈpidərs(ə)n
unto=ˈənˌtu
prove=pruv
sheep=ʃip
otherwise=ˈəðərˌwaɪz
mapped=mæpt
ideal=aɪˈdi(ə)l
marathon=ˈmɛrəˌθɑn
midland=ˈmɪdlən(d)
discretion=dᵻˈskrɛʃən
she=ʃi
brit=brɪt
mess=mɛs
stadium=ˈsteɪdiəm
candidate=ˈkæn(d)əˌdeɪt
custody=ˈkəstədi
henry=ˈhɛnri
fatal=ˈfeɪd(ə)l
merely=ˈmɪrli
ease=iz
spa=spɑ
correspondence=ˌkɔrəˈspɑnd(ə)n(t)s
microwave=ˈmaɪkroʊˌweɪv
clause=klɔz
premiere=priˈmɪ(ə)r
ross=rɔs
excellent=ˈɛks(ə)lənt
classify=ˈklæsəˌfaɪ
delight=dəˈlaɪt
macromelia=ˌmækroʊˈmiliə
mobee=ˈmoʊbi
namibian=nəˈmɪbiən
majority=məˈdʒɑrədi
innovative=ˈɪnəˌveɪdɪv
upgrade=ˈəpˌɡreɪd
instantly=ˈɪn(t)stən(t)li
blonde=blɑnd
swing=swɪŋ
viking=ˈvaɪkɪŋ
employ=ᵻmˈplɔɪ
goest=ˈɡoʊəst
carbo=ˈkɑrboʊ
passion=ˈpæʃən
founder=ˈfaʊndər
kit=kɪt
duck=dək
yea=jeɪ
highway=ˈhaɪˌweɪ
cooper=ˈkupər
quarterly=ˈkwɔrdərli
kerry=ˈkɛri
participation=pɑrˌtɪsᵻˈpeɪʃən
bronze=brɑnz
allergy=ˈælərdʒi
promptly=ˈprɑm(p)tli
monitor=ˈmɑnədər
maximize=ˈmæksəˌmaɪz
bang-up=ˈbæŋəp
like=laɪk
sharn=ʃɑrn
accommodation=əˌkɑməˈdeɪʃən
beginner=bəˈɡɪnər
joseph=ˈdʒoʊzəf
audience=ˈɔdiən(t)s
sydney=ˈsɪdni
exclusion=ɪkˈskluʒ(ə)n
frankfurter=ˈfræŋkfərdər
java=ˈdʒɑvə
thesis=ˈθisᵻs
gore=ɡɔr
receptor=rəˈsɛptər
dramatically=drəˈmædək(ə)li
via=ˈvaɪə
african=ˈæfrəkən
advertising=ˈædvərˌtaɪzɪŋ
port=pɔrt
realize=ˈri(ə)ˌlaɪz
cult=kəlt
caution=ˈkɔʃən
intent=ᵻnˈtɛnt
bother=ˈbɑðər
reference=ˈrɛf(ə)rən(t)s
dom=dɑm
campaign=kæmˈpeɪn
entertainment=ˌɛn(t)ərˈteɪnmənt
accessible=əkˈsɛsəb(ə)l
exhibit=ɪɡˈzɪbət
laser=ˈleɪzər
accompany=əˈkəmp(ə)ni
allow=əˈlaʊ
brave=breɪv
opening=ˈoʊp(ə)nɪŋ
efficiently=əˈfɪʃən(t)li
leo=ˈlioʊ
neon=ˈniˌɑn
medal=ˈmɛd(ə)l
purpose=ˈpərpəs
trademark=ˈtreɪdˌmɑrk
edit=ˈɛdət
costume=ˈkɑsˌt(j)um
ferison=fɛˈrʌɪsɒn
approval=əˈpruv(ə)l
supreme=sʊˈprɛm
gothic=ˈɡɑθɪk
mechanic=məˈkænɪk
nightmare=ˈnaɪtˌmɛ(ə)r
memory=ˈmɛm(ə)ri
industry=ˈɪndəstri
accent=ˈækˌsɛnt
clock=klɑk
cancel=ˈkæn(t)s(ə)l
blink=blɪŋk
guest=ɡɛst
name=neɪm
modem=ˈmoʊdəm
dealer=ˈdilər
oracle=ˈɔrək(ə)l
knight=naɪt
coating=ˈkoʊdɪŋ
colombian=kəˈləmbiən
picnic=ˈpɪkˌnɪk
comp=kɑmp
mississippi=ˌmɪsᵻˈsɪpi
routine=ruˈtin
waterproof=ˈwɔdərˌpruf
bon=bɑn
bukkake=buˈkɑˌkeɪ
north-east=ˌnɔrθˈist
tropical=ˈtrɑpəkəl
farmer=ˈfɑrmər
alice=ˈæləs
investment=ᵻnˈvɛs(t)m(ə)nt
brick=brɪk
affair=əˈfɛ(ə)r
saidest=ˈsɛdəst
mic=maɪk
duke=d(j)uk
danaid=ˈdaneɪɪd
creativity=ˌkrieɪˈtɪvᵻdi
sass=sæs
roofs=rufs
fault=fɔlt
ciao=tʃaʊ
instance=ˈɪnst(ə)n(t)s
halloween=ˌhæləˈwin
mem=mɛm
qajar=ˈkɑˌdʒɑr
harmful=ˈhɑrmf(ə)l
recipe=ˈrɛsəˌpi
colony=ˈkɑləni
hourly=ˈaʊərli
vic=vɪk
zero=ˈzɪroʊ
warrior=ˈwɔriər
don't=doʊnt
retreat=rəˈtrit
inter=ˈɪntə
delegation=ˌdɛləˈɡeɪʃən
repair=rəˈpɛ(ə)r
hundred=ˈhəndrəd
member=ˈmɛmbər
learner=ˈlərnər
folder=ˈfoʊldər
lan=læn
slope=sloʊp
decor=ˈdɛkə
syntax=ˈsɪnˌtæks
bose=boʊz
ok=ˌoʊˈkeɪ
walnut=ˈwɔlˌnət
regard=rəˈɡɑrd
gardening=ˈɡɑrd(ə)nɪŋ
subcommittee=ˈsəbkəˌmɪdi
pound=paʊnd
rug=rəɡ
six=sɪks
bicycle=ˈbaɪˌsɪkəl
hareld=ˈharəld
pitch=pɪtʃ
dance=dæn(t)s
yugoslavian=ˌjuɡoʊˈslɑviən
ca-sa=kɑː sɑː
incidence=ˈɪn(t)sədn(t)s
pool=pul
conjunction=kənˈdʒəŋ(k)ʃən
encryption=ᵻnˈkrɪpʃən
whose=huz
reg=rɛdʒ
artwork=ˈɑrtˌwərk
disturb=dəˈstərb
boulevard=ˈbʊləˌvɑrd
seminar=ˈsɛməˌnɑr
tale=teɪl
suit=sut
paintball=ˈpeɪntˌbɔl
hearing=ˈhɪrɪŋ
thee=ði
nat=næt
community=kəˈmjunədi
upset=ˌəpˈsɛt
business=ˈbɪznᵻs
montaria=mɑn(t)əˈriə
walter=ˈwɔltər
gaming=ˈɡeɪmɪŋ
concept=ˈkɑnˌsɛpt
vista=ˈvɪstə
count=kaʊnt
gift=ɡɪft
eleven=əˈlɛv(ə)n
tommy=ˈtɑmi
pee=pi
distribute=dəˈstrɪbjut
univ=ˈjunəv
key=ki
women=ˈwɪmᵻn
bonus=ˈboʊnəs
linn=lɪn
outline=ˈaʊtˌlaɪn
perfectly=ˈpərfək(t)li
animal=ˈænəm(ə)l
guidance=ˈɡaɪdən(t)s
arise=əˈraɪz
network=ˈnɛtˌwərk
pope=poʊp
bloom=blum
highly=ˈhaɪli
firewall=ˈfaɪ(ə)rˌwɔl
disney=ˈdɪzni
lord=lɔrd
them=ðɛm
masterdom=ˈmæstərdəm
bio=ˈbaɪoʊ
citizenship=ˈsɪdᵻzənˌʃɪp
blackback=ˈblækˌbæk
photoshop=ˈfoʊdəˌʃɑp
nut=nət
soul=soʊl
cafe=kæˈfeɪ
frog=frɔɡ
lobby=ˈlɑbi
molecule=ˈmɑləˌkjul
minima=ˈmɪnəmə
fee=fi
statute=ˈstætʃut
laufen=ˈlaʊfən
divorce=dəˈvɔrs
hardcore=ˈhɑrdˌkɔr
audion=ˈɔdiɑn
paul=pɔl
payroll=ˈpeɪˌroʊl
difficult=ˈdɪfəkəlt
homeless=ˈhoʊmləs
vertex=ˈvərˌtɛks
grab=ɡræb
criminal=ˈkrɪmənl
mil=mɪl
unauthorized=ˌənˈɔθəˌraɪzd
vendor=ˈvɛndər
education=ˌɛdʒəˈkeɪʃən
moisture=ˈmɔɪstʃər
sunny=ˈsəni
weekend=ˈwikˌɛnd
furnishing=ˈfərnɪʃɪŋ
seek=sik
ambassador=æmˈbæsədər
wellness=ˈwɛlnəs
organism=ˈɔrɡəˌnɪzəm
efficient=əˈfɪʃənt
piano=piˈænoʊ
romantic=roʊˈmæn(t)ɪk
healthy=ˈhɛlθi
amino=əˈminoʊ
brilliant=ˈbrɪljənt
nick=nɪk
forth=fɔrθ
turbo=ˈtərboʊ
onion=ˈənj(ə)n
panic=ˈpænɪk
demo=ˈdɛmoʊ
funky=ˈfəŋki
everything=ˈɛv(ə)riˌθɪŋ
presently=ˈprɛzn(t)li
amplifier=ˈæmpləˌfaɪər
occasion=əˈkeɪʒ(ə)n
somebody=ˈsəmˌbɑdi
response=rəˈspɑn(t)s
travesty=ˈtrævəsti
separate=ˈsɛpəˌreɪt
autumn=ˈɔdəm
manufacturer=ˌmænjəˈfæktʃərər
combination=ˌkɑmbəˈneɪʃən
devon=ˈdɛvən
remen=ˈrɛmən
functionality=ˌfəŋ(k)ʃəˈnælədi
planet=ˈplænət
dangerous=ˈdeɪndʒ(ə)rəs
disagree=ˌdɪsəˈɡri
maintenance=ˈmeɪnt(ə)nən(t)s
sock=sɑk
deployment=dəˈplɔɪmənt
interface=ˈɪn(t)ərˌfeɪs
dosage=ˈdoʊsɪdʒ
totally=ˈtoʊdl̩i
monkey=ˈməŋki
adrian=ˈeɪdriən
rubaiyat=ˈrubiˌ(j)ɑt
opera=ˈɑp(ə)rə
enrol=ᵻnˈroʊl
excel=ɪkˈsɛl
campus=ˈkæmpəs
stay=steɪ
proprietary=p(r)əˈpraɪəˌtɛri
mathematics=ˌmæθ(ə)ˈmædɪks
practical=ˈpræktək(ə)l
nine=naɪn
fief=fif
midi=ˈmɪdi
prepaid=ˌpriˈpeɪd
aft=æft
basic=ˈbeɪsɪk
shave=ʃeɪv
rescue=ˈrɛskju
fish=fɪʃ
accurately=ˈækjərətli
attend=əˈtɛnd
microphone=ˈmaɪkrəˌfoʊn
earning=ˈərnɪŋ
trinity=ˈtrɪnɪti
bomb=bɑm
optimal=ˈɑptəm(ə)l
gradually=ˈɡrædʒ(ə)wəli
oak-land=ˈoʊk ˌlænd
virgin=ˈvərdʒən
visitor=ˈvɪzᵻdər
cattle=ˈkæd(ə)l
carman=ˈkɑrmən
korean=kəˈriən
essex=ˈɛsəks
boston=ˈbɔstən
calendar=ˈkæləndər
pin=pɪn
fleece=flis
ensemble=ɑnˈsɑmb(ə)l
behaviour=bəˈheɪvjər
prison=ˈprɪzn
delivery=dəˈlɪv(ə)ri
numerous=ˈn(j)um(ə)rəs
consult=kənˈsəlt
musical=ˈmjuzək(ə)l
exceed=ɪkˈsid
ion=ˈaɪən
marc=mɑrk
overcome=ˌoʊvərˈkəm
context=ˈkɑntɛkst
introduction=ˌɪntrəˈdəkʃən
widespread=ˈwaɪdˌsprɛd
mar=mɑr
pole=poʊl
special=ˈspɛʃ(ə)l
remix=riˈmɪks
stylus=ˈstaɪləs
temp=tɛmp
crypt=krɪpt
educational=ˌɛdʒəˈkeɪʃ(ə)nəl
wood=wʊd
genom=ˈdʒinəm
jail=dʒeɪl
chairman=ˈtʃɛrmən
colin=ˈkɑlən
permit=pərˈmɪt
toolbar=ˈtulˌbɑr
jewel=ˈdʒu(ə)l
letter=ˈlɛdər
assault=əˈsɔlt
lap=læp
offer=ˈɔfər
automation=ˌɔdəˈmeɪʃən
occupation=ˌɑkjəˈpeɪʃən
scratch=skrætʃ
nuke=n(j)uk
trust=trəst
robust=roʊˈbəst
hopefully=ˈhoʊpf(ə)li
many=ˈmɛni
percentage=pərˈsɛn(t)ɪdʒ
compact=ˈkɑmˌpæk(t)
promotional=prəˈmoʊʃ(ə)nəl
angola=æŋˈɡoʊlə
injure=ˈɪndʒər
comfortable=ˈkəmfərdəb(ə)l
livebox=ˈlaɪvˌbɑks
companion=kəmˈpænjən
ma-mie=ˌmɑ ˈmi
alignment=əˈlaɪnmənt
distance=ˈdɪst(ə)n(t)s
barcelona=ˌbɑrsəˈloʊnə
disappoint=ˌdɪsəˈpɔɪnt
motherboard=ˈməðərˌbɔrd
cast=kæst
pull=pʊl
inspire=ᵻnˈspaɪ(ə)r
relief=rəˈlif
remark=rəˈmɑrk
crime=kraɪm
custom=ˈkəstəm
publicity=pəˈblɪsᵻdi
liberal=ˈlɪb(ə)rəl
oscar=ˈɑskər
sty=staɪ
convict=kənˈvɪkt
book=bʊk
nelson=ˈnɛls(ə)n
opportunity=ˌɑpərˈt(j)unədi
essentially=əˈsɛn(t)ʃəli
well=wɛl
identity=aɪˈdɛn(t)ədi
sun=sən
matthew=ˈmæθju
then=ðɛn
monthly=ˈmənθli
guam=ɡwɑm
departure=dəˈpɑrtʃər
divine=dəˈvaɪn
overseas=ˌoʊvərˈsiz
interior=ᵻnˈtɪriər
consequently=ˈkɑn(t)səkwən(t)li
enter=ˈɛn(t)ər
might=maɪt
reporter=rəˈpɔrdər
smithsonian=ˌsmɪθˈsoʊniən
san=sæn
accurate=ˈækjərət
applicable=ˈæpləkəb(ə)l
distinction=dəˈstɪŋ(k)ʃən
deaf=dɛf
extreme=ɪkˈstrim
meaningful=ˈminɪŋf(ə)l
washer=ˈwɔʃər
sympathy=ˈsɪmpəθi
lifetime=ˈlaɪfˌtaɪm
gauge=ɡeɪdʒ
ware=wɛ(ə)r
wide=waɪd
comparable=ˈkɑmp(ə)rəb(ə)l
multimedia=ˌməltiˈmidiə
prefer=priˈfər
pharmacology=ˌfɑrməˈkɑlədʒi
seasonal=ˈsiz(ə)n(ə)l
turtle=ˈtərd(ə)l
move=muv
distributor=dəˈstrɪbjədər
across=əˈkrɔs
catherine=ˈkaθərɪn
andorran=ænˈdɔrən
liberty=ˈlɪbərdi
pilot=ˈpaɪlət
reasonably=ˈrizn̩əbli
passive=ˈpæsɪv
auto=ˈɔdoʊ
fav=feɪv
festival=ˈfɛstəv(ə)l
admission=ədˈmɪʃən
creek=krik
decimal=ˈdɛs(ə)məl
excitement=ɪkˈsaɪtmənt
realm=rɛlm
make-up=ˈmeɪˌkəp
faq=ˌɛfeɪˈkju
layout=ˈleɪˌaʊt
dirty=ˈdərdi
now=naʊ
numerical=n(j)uˈmɛrək(ə)l
freebase=ˈfriˌbeɪs
newfoundland=ˈn(j)ufən(d)lən(d)
kill=kɪl
termination=ˌtərməˈneɪʃən
coden=ˈkoʊd(ə)n
ivory=ˈaɪv(ə)ri
platinum=ˈplætn̩əm
deputy=ˈdɛpjədi
null=nəl
appeal=əˈpil
flight=flaɪt
january=ˈdʒænjəˌwɛri
vegetation=ˌvɛdʒəˈteɪʃən
commerce=ˈkɑmərs
santa=ˈsæn(t)ə
mali=ˈmɑli
caroline=ˈkɛrəˌlaɪn
dildo=ˈdɪlˌdoʊ
privilege=ˈprɪv(ə)lɪdʒ
valid=ˈvæləd
graduate=ˈɡrædʒʊˌeɪt
bee=bi
their=ðɛr
cam=kæm
blind=blaɪnd
bestiality=ˌbɛstʃiˈælədi
sql=ˌɛsˌkjuˈɛl
handmade=ˈhæn(d)ˌmeɪd
nationally=ˈnæʃ(ə)nəli
carpet=ˈkɑrpət
fact=fæk(t)
wool=wʊl
dividend=ˈdɪvəˌdɛnd
telephony=təˈlɛfəni
adjust=əˈdʒəst
arena=əˈrinə
furnish=ˈfərnɪʃ
package=ˈpækɪdʒ
answer=ˈæn(t)sər
alternatively=ɔlˈtərnədᵻvli
darwin=ˈdɑrwᵻn
congressional=kənˈɡrɛʃ(ə)nəl
minute=ˈmɪnᵻt
workplace=ˈwərkˌpleɪs
diy=ˌdiaɪˈwaɪ
announce=əˈnaʊn(t)s
wow=waʊ
advocacy=ˈædvəkəsi
offensive=əˈfɛn(t)sɪv
sullivan=ˈsʌlɪvən
composer=kəmˈpoʊzər
behind=bəˈhaɪnd
good=ɡʊd
insulin=ˈɪn(t)səlᵻn
behalf=bəˈhæf
genome=ˈdʒiˌnoʊm
pride=praɪd
yellow=ˈjɛloʊ
burke=bərk
continually=kənˈtɪnj(ʊ)əli
traveller=ˈtræv(ə)lər
mover=ˈmuvər
unexpected=ˌənᵻkˈspɛktəd
idee=aɪˈdi
specialty=ˈspɛʃ(ə)lti
instructor=ᵻnˈstrəktər
attendance=əˈtɛnd(ə)n(t)s
convenience=kənˈvinjən(t)s
investigation=ᵻnˌvɛstəˈɡeɪʃən
subdivision=ˈsəbdəˌvɪʒən
saint=seɪnt
vietnamese=viˌɛtnəˈmiz
calm=kɑ(l)m
consultant=kənˈsəltnt
bag=bæɡ
brighten=ˈbraɪtn
morgan=ˈmɔrɡ(ə)n
recommendation=ˌrɛkəmənˈdeɪʃən
hour=ˈaʊ(ə)r
basement=ˈbeɪsm(ə)nt
commitment=kəˈmɪtm(ə)nt
understand=ˌəndərˈstænd
motorama=ˌmoʊdəˈræmə
pod=pɑd
north-west=ˌnɔrθˈwɛst
hatti=ˈhædi
satin=ˈsætn
rich=rɪtʃ
abstract=ˈæbˌstræk(t)
become=bəˈkəm
hill=hɪl
screen=skrin
hydrogen=ˈhaɪdrədʒ(ə)n
e-book=ˈiˌbʊk
overhead=ˌoʊvərˈhɛd
storage=ˈstɔrɪdʒ
forget=fərˈɡɛt
et-cetera=ɛt ˈsɛtərə
check=tʃɛk
contractor=ˈkɑntræktər
bestseller=ˌbɛs(t)ˈsɛlər
derive=dəˈraɪv
legal=ˈliɡəl
n't=(ə)nt
reuters=ˈrɔɪdərz
bid=bɪd
notice=ˈnoʊdəs
mightn't=ˈmaɪtn(t)
bachelor=ˈbætʃ(ə)lər
ballas=ˈbæləs
jury=ˈdʒʊri
privacy=ˈpraɪvəsi
violent=ˈvaɪ(ə)lənt
wrong=rɔŋ
elvish=ˈɛlvɪʃ
comparison=kəmˈpɛrəs(ə)n
wild-life=ˈwaɪl(d) ˌlaɪf
flash=flæʃ
guitar=ɡəˈtɑr
journalism=ˈdʒərnlˌɪzəm
cincinnatian=sɪnsɪˈnatɪən
chapel=ˈtʃapəl
recently=ˈrisn(t)li
graphical=ˈɡræfək(ə)l
relatively=ˈrɛlədᵻvli
skill=skɪl
sensor=ˈsɛn(t)sər
occurrence=əˈkərən(t)s
potter=ˈpɑdər
uni=ˈjuni
deck=dɛk
sublime=səˈblaɪm
senses=ˌɔfˈlaɪn
melissa=məˈlɪsə
unsubscribe=ˌənsəbˈskraɪb
install=ᵻnˈstɔl
id=ɪd
dat=ˌdieɪˈti
fox=fɑks
pass=pæs
steward=ˈst(j)uərd
tape=teɪp
resist=rəˈzɪst
resource=ˈriˌsɔrs
civil=ˈsɪvᵻl
wish=wɪʃ
disposal=dəˈspoʊz(ə)l
translator=ˈtrænzˌleɪdər
talent=ˈtælənt
just=dʒəst
income=ˈɪnˌkəm
oughtn't=ˈɔtnt
finite=ˈfaɪˌnaɪt
pas=pɑ
provision=prəˈvɪʒ(ə)n
kay=keɪ
indianapolis=ˌɪndiəˈnæp(ə)ləs
send=sɛnd
so=soʊ
chun=tʃuːn
ham=hæm
desk=dɛsk
mill=mɪl
alias=ˈeɪliəs
hypothetical=ˌhaɪpəˈθɛdəkəl
aberdeen=ˌæbərˈdin
mainstream=ˈmeɪnˌstrim
mike=maɪk
abortion=əˈbɔrʃən
monach=ˈmɑnək
satellite=ˈsædlˌaɪt
tulsi=ˈtʊlsi
company=ˈkəmp(ə)ni
rayleigh=ˈreɪli
perceive=pərˈsiv
mon=moʊn
scene=sin
generous=ˈdʒɛn(ə)rəs
indonesian=ˌɪndəˈniʒən
mail=meɪl
star=stɑr
remain=rəˈmeɪn
itself=ᵻtˈsɛlf
excuse=ɪkˈskjus
wear=wɛ(ə)r
gambling=ˈɡæmb(ə)lɪŋ
circular=ˈsərkjələr
interim=ˈɪn(t)ərəm
rehab=ˈriˌhæb
way=weɪ
busty=ˈbəsti
mortgage=ˈmɔrɡɪdʒ
nature=ˈneɪtʃər
sticky=ˈstɪki
proctor=ˈprɑktər
nike=ˈnaɪki
use=ˌɛsaɪˈɛm
exhaust=ɪɡˈzɔst
trans=trænz
paratonic=ˌpɛrəˈtɑnɪk
before=bəˈfɔr
manufacture=ˌmæn(j)əˈfæk(t)ʃər
sheffield=ˈʃɛfild
ethiopian=ˌiθiˈoʊpiən
mice=maɪs
genealogy=ˌdʒiniˈɑlədʒi
strike=straɪk
fool=ful
leader=ˈlidər
wolf=wʊlf
pgp=ˌpiˌdʒiˈpi
sole=soʊl
elimination=əˌlɪməˈneɪʃən
husband=ˈhəzb(ə)n(d)
timeline=ˈtaɪmˌlaɪn
testament=ˈtɛstəmənt
drum=drəm
flour=ˈflaʊ(ə)r
wrought=rɔt
perspective=pərˈspɛktɪv
bookmark=ˈbʊkˌmɑrk
survey=ˈsərˌveɪ
solo=ˈsoʊˌloʊ
big-head=ˈbɪɡˌ(h)ɛd
welkin=ˈwɛlkən
broadband=ˈbrɔdˌbænd
workflow=ˈwərkˌfloʊ
yes's=ˈjɛsəz
mica=ˈmaɪkə
sentence=ˈsɛntn(t)s
hollow=ˈhɑloʊ
organizer=ˈɔrɡəˌnaɪzər
conventional=kənˈvɛn(t)ʃ(ə)nəl
continuity=ˌkɑn(t)əˈn(j)uədi
write=raɪt
karma=ˈkɑrmə
delaware=ˈdɛləˌwɛr
gif=ɡɪf
poultry=ˈpoʊltri
cuisine=kwəˈzin
broadway=ˈbrɔdˌweɪ
fairy=ˈfɛri
celebration=ˌsɛləˈbreɪʃən
workout=ˈwərkˌaʊt
academic=ˌækəˈdɛmɪk
reduce=rəˈd(j)us
newsletter=ˈn(j)uzˌlɛdər
waste=weɪst
august=ɔˈɡəst
ecology=iˈkɑlədʒi
political=pəˈlɪdᵻk(ə)l
therefore=ˈðɛrˌfɔr
herisson=ˈhɛrɪsən
improvement=ᵻmˈpruvmənt
narrow=ˈnɛroʊ
doom=dum
rhythm=ˈrɪðəm
czech=tʃɛk
chi=kaɪ
commentary=ˈkɑmənˌtɛri
jerry=ˈdʒɛri
empirical=ᵻmˈpɪrᵻk(ə)l
offence=əˈfɛn(t)s
spiritual=ˈspɪrᵻtʃ(əw)əl
agenda=əˈdʒɛndə
flexibility=ˌflɛksəˈbɪlᵻdi
copper=ˈkɑpər
isa=ˈaɪsə
forge=fɔrdʒ
obvious=ˈɑbviəs
virtual=ˈvərtʃ(əw)əl
thursday=ˈθərzˌdeɪ
ipod=ˈaɪˌpɑd
tuesday=ˈt(j)uzˌdeɪ
pocket=ˈpɑkət
flesh=flɛʃ
evanescence=ɛvəˈnɛsəns
peace=pis
upskirt=ˈəpˌskərt
liberian=laɪˈbɪriən
nationwide=ˌneɪʃənˈwaɪd
record=rəˈkɔrd
zen=zɛn
wonderful=ˈwəndərf(ə)l
expose=ɪkˈspoʊz
lat=læt
equally=ˈikwəli
geography=dʒiˈɑɡrəfi
float=floʊt
inspiration=ˌɪnspəˈreɪʃən
wilderness=ˈwɪldərnəs
pest=pɛst
suddenly=ˈsəd(ə)nli
tab=tæb
voltage=ˈvoʊltɪdʒ
instrumental=ˌɪn(t)strəˈmɛn(t)l
keyword=ˈkiˌwərd
sphere=sfɪ(ə)r
fuji=ˈfudʒi
questionnaire=ˌkwɛstʃəˈnɛ(ə)r
robertian=rɑˈbərdiən
erotic=əˈrɑdɪk
prototype=ˈproʊdəˌtaɪp
actor=ˈæktər
bloody=ˈblədi
methodology=ˌmɛθəˈdɑlədʒi
honda=ˈhɑndə
headquarters=ˈhɛdˌkwɔrdərz
vintage=ˈvɪn(t)ɪdʒ
exclude=ɪkˈsklud
sin=sɪn
shore=ʃɔr
timothy=ˈtɪməθi
tower=ˈtaʊər
deer=dɪ(ə)r
hock=hɑk
catholic=ˈkæθ(ə)lɪk
symphony=ˈsɪmfəni
input=ˈɪnˌpʊt
packet=ˈpækət
beyond=biˈ(j)ɑnd
lib=lɪb
massachusett=ˌmæsəˈtʃusət
jerusalem=dʒəˈrus(ə)ləm
desert=dəˈzərt
resistant=rəˈzɪst(ə)nt
brunswick=ˈbrənzˌwɪk
press-on=ˌprɛsˈɔn
aba=ˈæbə
confident=ˈkɑnfəd(ə)nt
jacob=ˈdʒeɪˌkɑb
roy=rɔɪ
daniell=ˈdænjəl
thou=ðaʊ
tile=taɪl
unusual=ˌənˈjuʒ(əw)əl
occur=əˈkər
flu=flu
internet=ˈɪn(t)ərˌnɛt
indicator=ˈɪndəˌkeɪdər
spice=spaɪs
chevy=ˈtʃɛvi
december=diˈsɛmbər
unite=juˈnaɪt
out=aʊt
vault=vɔlt
revolutionary=ˌrɛvəˈluʃəˌnɛri
mention=ˈmɛn(t)ʃ(ə)n
van-courier=ˈvænˌkʊriər
installation=ˌɪnztəˈleɪʃən
holocaust=ˈhɑləˌkɔst
wax=wæks
stan=stæn
headset=ˈhɛdˌsɛt
scientist=ˈsaɪəntəst
sweden=ˈswiːd(ə)n
net=nɛt
responsibility=rəˌspɑn(t)səˈbɪlᵻdi
delicious=dəˈlɪʃəs
identifier=aɪˈdɛn(t)əˌfaɪər
camp=kæmp
anxiety=æŋˈzaɪədi
continuously=kənˈtɪnjəwəsli
reviewer=rəˈvjuər
aestel=ˈæstl
precipitation=priˌsɪpəˈteɪʃən
publication=ˌpəbləˈkeɪʃən
electoral=əˈlɛkt(ə)rəl
pal=pæl
inn=ɪn
road=roʊd
charm=tʃɑrm
garrison=ˈɡɛrəs(ə)n
informational=ˌɪnfərˈmeɪʃ(ə)nəl
title=ˈtaɪdəl
arkansas=ˈɑrkənˌsɔ
would=wʊd
staff=stæf
reward=rəˈwɔrd
daddy=ˈdædi
lover=ˈləvər
vehicle=ˈviək(ə)l
establish=əˈstæblɪʃ
reid=rid
madid=ˈmædɪd
specify=ˈspɛsəˌfaɪ
war=wɔr
church=tʃərtʃ
cocktail=ˈkɑkˌteɪl
bob=bɑb
puzzle=ˈpəz(ə)l
receive=rəˈsiv
wit=wɪt
cost=kɔst
believe=bəˈliv
deviation=ˌdiviˈeɪʃən
doe=doʊ
bit=bɪt
monday=ˈmənˌdeɪ
tub=təb
render=ˈrɛndər
ide=aɪd
pleasant=ˈplɛznt
her=hər
officially=əˈfɪʃəli
beast=bist
jay=dʒeɪ
correct=kəˈrɛk(t)
germane=dʒərˈmeɪn
daisy=ˈdeɪzi
attractive=əˈtræktɪv
easy=ˈizi
myrtle=ˈmərd(ə)l
algerian=ælˈdʒɪriən
amongst=əˈməŋ(k)st
dean=din
seeker=ˈsikər
longitude=ˈlɔndʒᵻˌt(j)ud
rean=rin
thong=θɔŋ
palace=ˈpæləs
navigate=ˈnævəˌɡeɪt
opposite=ˈɑpəzət
pepper=ˈpɛpər
mission=ˈmɪʃən
quanta=ˈkwɑn(t)ə
author=ˈɔθər
harper=ˈhɑrpər
removable=rəˈmuvəb(ə)l
apparently=əˈpɛrən(t)li
russell=ˈrəs(ə)l
salem=ˈseɪləm
dryer=ˈdraɪ(ə)r
hygiene=ˈhaɪˌdʒin
revise=rəˈvaɪz
hansard=ˈhansəd
car=kɑr
converter=kənˈvərdər
sunrise=ˈsənˌraɪz
apache=əˈpætʃi
opposition=ˌɑpəˈzɪʃən
does=dəz
shape=ʃeɪp
symposium=sɪmˈpoʊziəm
fascinate=ˈfæsəˌneɪt
scientific=ˌsaɪənˈtɪfɪk
malaysian=məˈleɪʒ(ə)n
lose=luz
admit=ədˈmɪt
dry=draɪ
congress=ˈkɑŋɡrəs
virtue=ˈvərtʃu
pending=ˈpɛndɪŋ
bank=bæŋk
productive=prəˈdəktɪv
penetration=ˌpɛnəˈtreɪʃən
similarly=ˈsɪm(ə)lərli
bondage=ˈbɑndɪdʒ
bendy=ˈbɛndi
hairy=ˈhɛri
jesse=ˈdʒɛsi
anytime=ˈɛniˌtaɪm
syracuse=ˈsʌɪərəkjuːz
screenshot=ˈskrinˌʃɑt
idle=ˈaɪd(ə)l
eventually=əˈvɛn(t)ʃəli
bullet=ˈbʊlət
construct=kənˈstrək(t)
automatic=ˌɔdəˈmædɪk
celebrate=ˈsɛləˌbreɪt
city=ˈsɪdi
nudist=ˈn(j)udəst
dense=dɛn(t)s
palestine=ˈpæləˌstaɪn
malta=ˈmɔltə
cashier=kæˈʃɪ(ə)r
adapt=əˈdæpt
wentest=ˈwɛn(t)əst
stephanic=stɪˈfanɪk
penis=ˈpinᵻs
exist=ɪɡˈzɪst
pence=pɛn(t)s
compliance=kəmˈplaɪən(t)s
facilitate=fəˈsɪləˌteɪt
battle=ˈbæd(ə)l
adware=ˈædˌwɛ(ə)r
balloon=bəˈlun
lither=ˈlɪðə
acceptable=əkˈsɛptəb(ə)l
success=səkˈsɛs
collapse=kəˈlæps
sacrament=ˈsækrəmənt
vibrator=ˈvaɪˌbreɪdər
engage=ᵻnˈɡeɪdʒ
holy=ˈhoʊli
exam=ɪɡˈzæm
tire=ˈtaɪ(ə)r
norway=ˈnɔrweɪ
deem=dim
die=daɪ
springfield=ˈsprɪŋˌfild
tend=tɛnd
sept=sɛpt
brethren=ˈbrɛð(ə)rən
swap=swɑp
eric=ˈɛrək
olympic=əˈlɪmpɪk
exceptional=ᵻkˈsɛpʃ(ə)nəl
flavour=ˈfleɪvər
pupil=ˈpjup(ə)l
contamination=kənˌtæməˈneɪʃən
today=təˈdeɪ
oops=(w)ʊps
restructuring=riˈstrək(t)ʃərɪŋ
simply=ˈsɪmpli
dream=drim
proud=praʊd
spear=spɪ(ə)r
angelled=ˈeɪndʒəld
christian=ˈkrɪstʃən
neutral=ˈn(j)utr(ə)l
turner=ˈtərnər
recognize=ˈrɛkə(ɡ)ˌnaɪz
vatican=ˈvædəkən
lee=li
wheel=(h)wil
carolina=ˌkɛrəˈlaɪnə
artist=ˈɑrdəst
document=ˈdɑkjəˌmɛnt
isaac=ˈaɪzək
endorse=ᵻnˈdɔrs
projector=prəˈdʒɛktər
noun=ˈɪn(t)ərˌsteɪt
warcraft=ˈwɔːkrɑːft
myself=maɪˈsɛlf
nickle=ˈnɪk(ə)l
thousand=ˈθaʊz(ə)n(d)
devote=dəˈvoʊt
expo=ˈɛkˌspoʊ
here=hɪ(ə)r
postcard=ˈpoʊs(t)ˌkɑrd
oasis=oʊˈeɪsᵻs
podcast=ˈpɑdˌkæst
separately=ˈsɛp(ə)rətli
mirror=ˈmɪrər
hawk=hɔk
terrible=ˈtɛrəb(ə)l
ski=ski
experience=ɪkˈspɪriən(t)s
miss=mɪs
useful=ˈjusf(ə)l
conditional=kənˈdɪʃ(ə)nəl
representation=ˌrɛprəˌzɛnˈteɪʃən
profit=ˈprɑfət
minnesota=ˌmɪnəˈsoʊdə
kernel=ˈkərn(ə)l
aaron=ˈɛrən
aware=əˈwɛ(ə)r
clearance=ˈklɪrən(t)s
texas=ˈtɛksəs
underground=ˈəndərˌɡraʊnd
charitable=ˈtʃɛrədəb(ə)l
gnome=noʊm
print=prɪnt
premise=ˈprɛməs
teller=ˈtɛlər
magical=ˈmædʒəkəl
government=ˈɡəvər(n)mənt
consultation=ˌkɑn(t)səlˈteɪʃən
prevention=priˈvɛn(t)ʃ(ə)n
wet=wɛt
analytical=ˌænəˈlɪdᵻk(ə)l
architect=ˈɑrkəˌtɛk(t)
wisdom=ˈwɪzdəm
chicken=ˈtʃɪkən
casual=ˈkæʒuəl
cover=ˈkəvər
developer=dəˈvɛləpər
keno=ˈkinoʊ
charter=ˈtʃɑrdər
lucy=ˈlusi
refer=rəˈfər
height=haɪt
tribe=traɪb
website=ˈwɛbˌsaɪt
relevant=ˈrɛləv(ə)nt
normally=ˈnɔrməli
cartridge=ˈkɑrtrɪdʒ
smell=smɛl
math=mət
mai=maɪ
already=ˌɔlˈrɛdi
photography=fəˈtɑɡrəfi
allowance=əˈlaʊən(t)s
military=ˈmɪləˌtɛri
buss=bəs
confirmation=ˌkɑnfərˈmeɪʃən
pencil=ˈpɛn(t)s(ə)l
ppc=ˌpiˌpiˈsi
extremely=ɪkˈstrimli
disclose=dəˈskloʊz
sega=ˈseɪɡə
gentleman=ˈdʒɛn(t)əlmən
dam=dæm
del=dɛl
praise=preɪz
sagey=ˈseɪdʒi
belle=bɛl
binary=ˈbaɪnəri
career=kəˈrɪ(ə)r
live-chat=ˌlaɪv ˈtʃæt
standing=ˈstændɪŋ
activist=ˈæktəvəst
indeed=ᵻnˈdid
cooth=kuːθ
fresh=frɛʃ
trance=træn(t)s
ownership=ˈoʊnərˌʃɪp
push=pʊʃ
judicial=dʒuˈdɪʃəl
attitude=ˈædəˌt(j)ud
dozen=ˈdəz(ə)n
url=ˌjuɑrˈɛl
hydroclone=ˈhaɪdrəˌkloʊn
campion=ˈkæmpiən
launch=lɔn(t)ʃ
recruit=rəˈkrut
quetsch=kvɛtʃ
barry=ˈbɑːri
tourist=ˈtʊrəst
radii=ˈreɪdiaɪ
clone=kloʊn
aquarium=əˈkwɛriəm
saith=sɛθ
moore=mʊ(ə)r
ad=æd
automate=ˈɔdəˌmeɪt
presidential=ˌprɛzəˈdɛn(t)ʃ(ə)l
epibiont=ɛpɪˈbʌɪɒnt
porno=ˈpɔrnoʊ
emotion=əˈmoʊʃən
alto=ˈæltoʊ
ukrainer=juˈkreɪnər
silk=sɪlk
lonely=ˈloʊnli
examine=ɪɡˈzæmən
satisfy=ˈsædəsˌfaɪ
mode=moʊd
marshall=ˈmɑrʃəl
sheer=ʃɪ(ə)r
curriculum=kəˈrɪkjələm
psychology=saɪˈkɑlədʒi
specification=ˌspɛsəfəˈkeɪʃən
II=riːˈvjuː
dentist=ˈdɛn(t)ᵻst
seven=ˈsɛvən
disclaimer=dɪˈskleɪmər
shadow=ˈʃædoʊ
pat=pæt
retirement=rəˈtaɪ(ə)rm(ə)nt
carby=ˈkɑrbi
honour=ˈɑnər
discuss=dᵻˈskəs
fourth=fɔrθ
load=loʊd
goes=ɡoʊz
pt=piˈti
spencer=ˈspɛn(t)sər
competition=ˌkɑmpəˈtɪʃən
strain=streɪn
nowhere=ˈnoʊˌ(h)wɛ(ə)r
pastor=ˈpæstər
encyclopaedia=ᵻnˌsaɪkləˈpidiə
insure=ᵻnˈʃʊ(ə)r
away=əˈweɪ
fuzzy=ˈfəzi
lane=leɪn
finnish=ˈfɪnɪʃ
merit=ˈmɛrət
tribute=ˈtrɪbjut
yacht=jɑt
workshop=ˈwərkˌʃɑp
erotica=ɛˈrɒtɪkə
prep=prɛp
viagra=vaɪˈæɡrə
burden=ˈbərd(ə)n
tuition=t(j)uˈɪʃən
lawn=lɔn
protect=prəˈtɛk(t)
radio=ˈreɪdioʊ
play=pleɪ
version=ˈvərʒən
tod=tɑd
marine=məˈrin
prescribe=priˈskraɪb
population=ˌpɑpjəˈleɪʃən
character=ˈkɛr(ə)ktər
urge=ərdʒ
tranny=ˈtræni
mom=mɑm
electricity=əˌlɛkˈtrɪsᵻdi
quick=kwɪk
floral=ˈflɔrəl
veteran=ˈvɛdərən
happy=ˈhæpi
recover=rəˈkəvər
forgot=fərˈɡɑt
chase=tʃeɪs
butter=ˈbədər
york=jɔrk
swift=swɪft
gage=ɡeɪdʒ
benefit=ˈbɛnəfɪt
hamburg=ˈhæmˌbərɡ
attract=əˈtræk(t)
contest=kənˈtɛst
consumer=kənˈs(j)umər
biz=bɪz
boulder=ˈboʊldər
livestock=ˈlaɪvˌstɑk
knew=n(j)u
complaint=kəmˈpleɪnt
practitioner=ˌprækˈtɪʃ(ə)nər
gang=ɡæŋ
comedy=ˈkɑmədi
keyboard=ˈkiˌbɔrd
hong=hɔŋ
commonwealth=ˌkɑmənˈwɛlθ
vietnik=ˈviːɛtnɪk
soviet=ˈsoʊviət
academy=əˈkædəmi
alone=əˈloʊn
exclusive=ɪkˈsklusɪv
invest=ᵻnˈvɛst
excerpt=ˈɛkˌsərpt
advisory=ədˈvaɪzəri
airline=ˈɛrˌlaɪn
folk=foʊk
instructional=ᵻnˈstrəkʃ(ə)nəl
adverse=ˈædˌvərs
creator=kriˈeɪdər
lion=ˈlaɪən
rural=ˈrʊr(ə)l
alexanders=ˌæləɡˈzændərz
rover=ˈroʊvər
supervision=ˌsupərˈvɪʒən
legendary=ˈlɛdʒənˌdɛri
teacher=ˈtitʃər
council=ˈkaʊn(t)s(ə)l
respectively=rəˈspɛktᵻvli
causey=ˈkɔːzeɪ
battlefield=ˈbæd(ə)lˌfild
performer=pərˈfɔrmər
observe=əbˈzərv
vocabulary=voʊˈkæbjəˌlɛri
masturbate=ˈmæstərˌbeɪt
internship=ˈɪnˌtərnˌʃɪp
navy=ˈneɪvi
only=ˈoʊnli
andrew=ˈænˌdru
south-west=ˌsaʊθˈwɛst
canada=ˈkænədə
pantyhose=ˈpæn(t)iˌ(h)oʊz
propecia=ˌproʊˈpiʃ(i)ə
sufficient=səˈfɪʃənt
green=ɡrin
entertain=ˌɛn(t)ərˈteɪn
steam=stim
ill=ɪl
showcase=ˈʃoʊˌkeɪs
museum=mjuˈziəm
una=ˈ(j)unə
enforcement=ᵻnˈfɔrsm(ə)nt
martial=ˈmɑrʃəl
rating=ˈreɪdɪŋ
judge=dʒədʒ
gennete=ɡɛˈniːt
supervisor=ˈsupərˌvaɪzər
metadata=ˈmɛdəˌdædə
wealth=wɛlθ
afraid=əˈfreɪd
celeb=səˈlɛb
hampshire=ˈhampʃə
bookshop=ˈbʊkˌʃɑp
client=ˈklaɪənt
toolbox=ˈtulˌbɑks
rush=rəʃ
jewellery=ˈdʒu(ə)lri
thesaurus=θəˈsɔrəs
coloured=ˈkələrd
elephant=ˈɛləfənt
lightning=ˈlaɪtnɪŋ
thereafter=ðɛˈræftər
mart=mɑrt
commonly=ˈkɑmənli
petition=pəˈtɪʃən
emphasis=ˈɛmfəsəs
shaft=ʃæft
situate=ˈsɪtʃəˌweɪt
martha=ˈmɑrθə
persian=ˈpərʒ(ə)n
efficiency=əˈfɪʃən(t)si
circulation=ˌsərkjəˈleɪʃən
assemble=əˈsɛmb(ə)l
symptom=ˈsɪm(p)təm
french=frɛn(t)ʃ
fine=faɪn
america=əˈmɛrəkə
tattoo=tæˈtu
label=ˈleɪbəl
hindu=ˈhɪndu
add=æd
cheese=tʃiz
mark=mɑrk
tatie=ˈteɪti
acknowledge=əkˈnɑlədʒ
sea=si
fax=fæks
weld=wɛld
although=ɔlˈðoʊ
ourselves=aʊrˈsɛlvz
remember=rəˈmɛmbər
lawsuit=ˈlɔˌsut
verification=ˌvɛrəfəˈkeɪʃən
ecological=ˌɛkəˈlɑdʒək(ə)l
portfolio=pɔrtˈfoʊlioʊ
adjustment=əˈdʒəs(t)m(ə)nt
specifically=spəˈsɪfᵻk(ə)li
hardwood=ˈhɑrdˌwʊd
fortune=ˈfɔrtʃən
honey=ˈhəni
corps=kɔr
idea=aɪˈdiə
wizard=ˈwɪzərd
retrieve=rəˈtriv
interact=ˌɪn(t)ərˈæk(t)
luxury=ˈləkʃ(ə)ri
bought=bɔt
evaluate=əˈvæljʊˌeɪt
learned=lərnd
robot=ˈroʊˌbɑt
accomplish=əˈkɑmplɪʃ
anyway=ˈɛniˌweɪ
align=əˈlaɪn
interference=ˌɪn(t)ərˈfɪrən(t)s
directory=dəˈrɛkt(ə)ri
marina=məˈrinə
gibson=ˈɡɪbsən
recipient=rəˈsɪpiənt
hull=həl
rid=rɪd
postage=ˈpoʊstɪdʒ
hybrid=ˈhaɪˌbrɪd
levitic=lɪˈvɪtɪk
cape=keɪp
supplement=ˈsəpləmənt
butt=bət
crowd=kraʊd
laden=ˈleɪd(ə)n
salad=ˈsæləd
audio=ˈɔdioʊ
priority=praɪˈɔrədi
nice=naɪs
rear=rɪ(ə)r
speak=spik
election=əˈlɛkʃən
beef=bif
glad=ɡlæd
alquerque=ˌælˈkɛrkeɪ
current=ˈkərənt
dike=daɪk
handbook=ˈhæn(d)ˌbʊk
macedonian=ˌmæsəˈdoʊniən
hansen=ˈhansən
mightest=ˈmaɪdᵻst
pant=pænt
prague=prɑɡ
stop=stɑp
relaxation=rəˌlækˈseɪʃən
verbal=ˈvərb(ə)l
owner=ˈoʊnər
slightly=ˈslaɪtli
lloyds=lɔɪdz
protective=prəˈtɛktɪv
pear=pɛ(ə)r
urban=ˈərbən
deb=dɛb
insight=ˈɪnˌsaɪt
achieve=əˈtʃiv
tiens=tjã
lease=liz
poet=ˈpoʊət
light=laɪt
sandwich=ˈsænˌ(d)wɪtʃ
aither=ˈeθər
railway=ˈreɪlˌweɪ
julian=ˈdʒuljən
cooperative=koʊˈɑp(ə)rədɪv
geology=dʒiˈɑlədʒi
warrant=ˈwɔrənt
floppy=ˈflɑpi
specialize=ˈspɛʃəˌlaɪz
lo=loʊ
naked=ˈneɪkᵻd
blast=blæst
latria=ləˈtraɪə
path=pæθ
cedar=ˈsidər
wake=weɪk
phentermine=ˌfɛnˈtərˌmin
historical=hɪˈstɔrək(ə)l
viewer=ˈvjuər
detection=dəˈtɛkʃən
miracle=ˈmɪrᵻk(ə)l
tan=tæn
reno=ˈrɛnoʊ
lingerie=ˌlɑn(d)ʒəˈreɪ
biotechnology=ˌbaɪoʊˌtɛkˈnɑlədʒi
importantly=ᵻmˈpɔrd(ə)ntli
circuit=ˈsərkət
republic=rəˈpəblɪk
hero=ˈhɪroʊ
worldlet=ˈwər(ə)ldlət
location=loʊˈkeɪʃən
plaza=ˈplɑzə
steven=stɛv(ə)n
tray=treɪ
camera=ˈkæm(ə)rə
concert=ˈkɑn(t)sərt
netscape=ˈnɛtˌskeɪp
parliamentary=ˌpɑrləˈmɛnt(ə)ri
uniform=ˈjunəˌfɔrm
religion=rəˈlɪdʒ(ə)n
perl=pərl
botswanan=ˌbɑtˈswɑnən
housewife=ˈhəzəf
tough=təf
validity=vəˈlɪdədi
ballot=ˈbælət
afternoon=ˌæftərˈnun
ascii=ˈæski
dependence=dəˈpɛnd(ə)n(t)s
pronto=ˈprɑn(t)oʊ
opponent=əˈpoʊnənt
parent=ˈpɛr(ə)nt
reason=ˈriz(ə)n
wrap=ræp
ralph=rælf
govern=ˈɡəvərn
obligation=ˌɑbləˈɡeɪʃən
alan=ˈælən
monton=ˈmɑnˌtɑn
competent=ˈkɑmpəd(ə)nt
emma=ˈɛmə
twelve=twɛlv
wed=wɛd
completely=kəmˈplitli
vacation=veɪˈkeɪʃən
fixture=ˈfɪkstʃər
bidder=ˈbɪdər
drill=drɪl
clothe=kloʊð
value=ˈvælju
fiscal=ˈfɪsk(ə)l
joe=dʒoʊ
drama-doc=ˈdrɑməˌdɑk
zoom=zum
moldovan=mɑlˈdoʊv(ə)n
reset=riˈsɛt
joy=dʒɔɪ
album=ˈælbəm
tension=ˈtɛnʃən
permanent=ˈpərm(ə)nənt
characterization=ˌkɛr(ə)ktərəˈzeɪʃən
shri=ʃri
rapid=ˈræpəd
compose=kəmˈpoʊz
dvd=ˌdiˌviˈdi
cove=koʊv
bogan=ˈboʊɡ(ə)n
obtain=əbˈteɪn
student=ˈst(j)ud(ə)nt
quest=kwɛst
gym=dʒɪm
signature=ˈsɪɡnətʃər
cabin=ˈkæbən
pea=pi
except=ᵻkˈsɛpt
pacific=pəˈsɪfɪk
monetary=ˈmɑnəˌtɛri
mayn't=ˈmeɪ(ə)nt
disco=ˈdɪskoʊ
copyright=ˈkɑpiˌraɪt
sey=seɪ
quizzee=kwɪˈzi
malpractice=ˌmælˈpræktəs
tree=tri
textile=ˈtɛkˌstaɪl
prerequisite=priˈrɛkwəzət
acquisition=ˌækwəˈzɪʃən
said=sɛd
preliminary=prəˈlɪməˌnɛri
dark=dɑrk
coverage=ˈkəv(ə)rɪdʒ
cook=kʊk
do=du
suite=swit
mac=mæk
bishop=ˈbɪʃəp
cache=kæʃ
alert=əˈlərt
interest=ˈɪnt(ə)rəst
proudly=ˈpraʊdli
lime=laɪm
whatever=(h)wədˈɛvər
pete=pit
non-profit=nɑnˈprɑfət
sight=saɪt
reception=rəˈsɛpʃən
merger=ˈmərdʒər
ought=ɔt
orgasm=ˈɔrˌɡæzəm
prescription=priˈskrɪpʃən
primarily=praɪˈmɛrəli
bury=ˈbɛri
anywhere=ˈɛniˌwɛr
ati=ˈædi
township=ˈtaʊnˌʃɪp
incorporate=ɪnˈkɔrpəˌreɪt
feeling=ˈfilɪŋ
because=bəˈkəz
district=ˈdɪstrɪk(t)
fitness=ˈfɪtnᵻs
stockholm=ˈstɑkˌhoʊ(l)m
query=ˈkwɪri
systematic=ˌsɪstəˈmædɪk
karaoke=ˌkɛriˈoʊki
dayton=ˈdeɪtn
leisure=ˈliʒər
karen=kəˈrɛn
massage=məˈsɑ(d)ʒ
ceramic=səˈræmɪk
merchant=ˈmərtʃənt
diana=daɪˈænə
adapter=əˈdæptər
quiet=ˈkwaɪət
crossword=ˈkrɔswərd
municipality=mjuˌnɪsəˈpælədi
ford=fɔrd
earn=ərn
aircraft=ˈɛrˌkræf(t)
inflation=ᵻnˈfleɪʃən
cheer=tʃɪ(ə)r
isolation=ˌaɪsəˈleɪʃən
watch=wɑtʃ
doest=ˈduəst
verify=ˈvɛrəˌfaɪ
vowels=ði
smile=smaɪl
suck=sək
nisan=ˈnɪsən
nicaragua=ˌnɪkəˈrɑɡwə
william=ˈwɪljəm
tall=tɔl
fellow=ˈfɛloʊ
assistant=əˈsɪstnt
hist=(h)st
cock=kɑk
literally=ˈlɪdərəli
breach=britʃ
particularly=pə(r)ˈtɪkjələrli
sustainable=səˈsteɪnəb(ə)l
debt=dɛt
manga=ˈmæŋɡə
cheat=tʃit
holly=ˈhɑli
visa=ˈvizə
ataxy=əˈtæksi
vegetable=ˈvɛdʒtəbəl
ind=ɪnd
kate=keɪt
moon=mun
internationally=ˌɪn(t)ərˈnæʃ(ə)nəli
nutrition=n(j)uˈtrɪʃən
ministry=ˈmɪnəstri
courier=ˈkʊriər
integrity=ᵻnˈtɛɡrədi
temperature=ˈtɛmpə(rə)tʃər
unique=ˌjuˈnik
namespace=ˈneɪmˌspeɪs
playlist=ˈpleɪˌlɪst
professional=prəˈfɛʃ(ə)nəl
finder=ˈfaɪndər
geometry=dʒiˈɑmətri
soc=sɒk
static=ˈstædɪk
clearly=ˈklɪrli
steel=stil
auditor=ˈɔdədər
columnist=ˈkɑləm(n)əst
consumption=kənˈsəm(p)ʃən
bloomery=ˈbluːməri
intelligence=ᵻnˈtɛlədʒ(ə)n(t)s
particular=pə(r)ˈtɪkjələr
republican=rəˈpəblək(ə)n
toy=tɔɪ
nothing=ˈnəθɪŋ
ability=əˈbɪlᵻdi
epsom=ˈɛpsəm
greenhouse=ˈɡrinˌ(h)aʊs
torture=ˈtɔrtʃər
object=ˈɑbdʒək(t)
orange=ˈɔr(ə)ndʒ
symbol=ˈsɪmb(ə)l
nutritional=n(j)uˈtrɪʃən(ə)l
cigarette=ˌsɪɡəˈrɛt
fetish=ˈfɛdɪʃ
bolt=boʊlt
figure=ˈfɪɡjər
lift=lɪft
instead=ᵻnˈstɛd
think=θɪŋk
weather=ˈwɛðər
sandy=ˈsændi
towards=tɔrdz
shareholder=ˈʃɛrˌ(h)oʊldər
law=lɔ
made=meɪd
successfully=səkˈsɛsfəli
animation=ˌænəˈmeɪʃən
equation=əˈkweɪʒən
sponsorship=ˈspɑn(t)sərˌʃɪp
configuration=kənˌfɪɡ(j)əˈreɪʃən
vid=vɪd
beat=bit
saidst=sɛdst
kenya=ˈkɛnjə
asthma=ˈæzmə
malawi=məˈlɑwi
lay=leɪ
truth=truθ
harrington=ˈhɛrɪŋt(ə)n
sec=sɛk
mahdi=ˈmɑdi
automatically=ˌɔdəˈmædək(ə)li
allege=əˈlɛdʒ
lao=laʊ
penny=ˈpɛni
northern=ˈnɔrðərn
mainly=ˈmeɪnli
passage=ˈpæsɪdʒ
montgomery=mɑn(t)ˈɡəm(ə)ri
basically=ˈbeɪsᵻk(ə)li
dimension=dəˈmɛn(t)ʃən
expense=ɪkˈspɛn(t)s
glossary=ˈɡlɔsəri
plenty=ˈplɛn(t)i
incur=ᵻnˈkər
zimbabwe=zɪmˈbɑbˌweɪ
geographic=ˌdʒiəˈɡræfɪk
hall=hɔl
merge=mərdʒ
configure=kənˈfɪɡjər
weapon=ˈwɛpən
squirt=skwərt
revolution=ˌrɛvəˈluʃən
accept=əkˈsɛpt
extra=ˈɛkstrə
brad=bræd
adolescent=ˌædlˈɛs(ə)nt
hentai=ˈhɛnˌtaɪ
palpal=ˈpælp(ə)l
force=fɔrs
egg=ɛɡ
siemens=ˈsimənz
jacket=ˈdʒækət
fate=feɪt
jujitsu=ˌdʒuˈdʒɪtsu
pregnant=ˈprɛɡnənt
warehouse=ˈwɛrˌhaʊs
greek=ɡrik
deposit=dəˈpɑzət
hence=hɛn(t)s
marian=ˈmɛriən
anthem=ˈænθəm
ricky=ˈrɪki
geological=ˌdʒiəˈlɑdʒək(ə)l
unsigned=ˌənˈsaɪnd
castle=ˈkæs(ə)l
mattress=ˈmætrəs
acid=ˈæsəd
prayer=prɛ(ə)r
sew=soʊ
eddy=ˈɛdi
co-ordinator=koʊˈɔrdəˌneɪdər
catalogue=ˈkædlˌɔɡ
foundation=faʊnˈdeɪʃən
recorder=rəˈkɔrdər
cyber=ˈsaɪbər
stp=ˌɛsˌtiˈpi
occasional=əˈkeɪʒən(ə)l
pontian=ˈpɑn(t)iən
discrimination=dᵻˌskrɪməˈneɪʃən
pace=peɪs
transform=træn(t)sˈfɔrm
sephen=ˈsɛfɛn
preservation=ˌprɛzərˈveɪʃən
say=seɪ
description=dəˈskrɪpʃən
trek=trɛk
colour=ˈkələr
sing=sɪŋ
albanian=ælˈbeɪniən
everywhere=ˈɛvriˌwɛr
atom=ˈædəm
joan=dʒoʊn
pay-station=ˈpeɪ ˌsteɪʃən
wi-fi=ˈwaɪˌfaɪ
kirk=kərk
collective=kəˈlɛktɪv
senate=ˈsɛnət
adam=ˈædəm
slave=sleɪv
hate=heɪt
exhibition=ˌɛksəˈbɪʃən
metre=ˈmidər
e'er=ɛ(ə)r
defeat=dəˈfit
bathroom=ˈbæθˌrum
novel=ˈnɑv(ə)l
token=ˈtoʊk(ə)n
cooperation=koʊˌɑpəˈreɪʃən
must=məst
dragon=ˈdræɡən
person=ˈpərs(ə)n
entity=ˈɛn(t)ədi
estimation=ˌɛstəˈmeɪʃən
agency=ˈeɪdʒən(t)si
father=ˈfɑðər
overnight=ˌoʊvərˈnaɪt
rachel=rəˈʃɛl
leadership=ˈlidərˌʃɪp
roster=ˈrɔstər
climate=ˈklaɪmᵻt
pipe=paɪp
faculty=ˈfæk(ə)lti
ancient=ˈeɪn(t)ʃənt
ben=bɛn
rabbit=ˈræbət
indigenous=ᵻnˈdɪdʒənəs
ade=eɪd
para=ˈpɛrə
niger=ˈnaɪdʒər
guess=ɡɛs
top=tɑp
prozac=ˈproʊˌzæk
knife=naɪf
yoga=ˈjoʊɡə
physician=fəˈzɪʃən
warm=wɔrm
personalized=ˈpərs(ə)nəˌlaɪzd
boy=bɔɪ
soldier=ˈsoʊldʒər
international=ˌɪn(t)ərˈnæʃ(ə)nəl
replication=ˌrɛpləˈkeɪʃən
distinguish=dəˈstɪŋɡwɪʃ
staves=steɪvz
sensitivity=ˌsɛn(t)səˈtɪvədi
those=ðoʊz
decent=ˈdis(ə)nt
pork=pɔrk
saturday=ˈsædərˌdeɪ
mandatory=ˈmændəˌtɔri
awful=ˈɔf(ə)l
broke=broʊk
desktop=ˈdɛs(k)ˌtɑp
few=fju
herein=ˌhɪrˈɪn
street=strit
television=ˈtɛləˌvɪʒən
precisely=priˈsaɪsli
antiguan=ænˈtiɡən
fight=faɪt
pine=paɪn
scenic=ˈsinɪk
solomon=ˈsɑləmən
florence=ˈflɔrən(t)s
it=ɪt
paperback=ˈpeɪpərˌbæk
counsel=ˈkaʊn(t)s(ə)l
buy=baɪ
pot=pɑt
composite=kəmˈpɑzət
red=rɛd
somehow=ˈsəmˌhaʊ
consolidate=kənˈsɑləˌdeɪt
sacrifice=ˈsækrəˌfaɪs
request=rəˈkwɛst
implement=ˈɪmpləˌmɛnt
retrieval=rəˈtriv(ə)l
opposed=əˈpoʊzd
want=wɑnt
johnny=ˈdʒɑni
politics=ˈpɑləˌtɪks
almost=ɔlˈmoʊst
fishery=ˈfɪʃəri
albert=ˈælbərt
such=sətʃ
degree=dəˈɡri
villa=ˈvɪlə
determination=dəˌtərməˈneɪʃən
exedra=ˈɛksɪdrə
rand=rænd
number=ˈnəmbər
dispatch=dəˈspætʃ
latitude=ˈlædəˌt(j)ud
morris=ˈmɔrəs
colchester=ˈkəʊltʃɛstə
hush=həʃ
crises=ˈkraɪˌsiz
teddy=ˈtɛdi
when=(h)wɛn
loud=laʊd
bristol=ˈbrɪstəl
rent=rɛnt
costa=ˈkɑstə
soccer=ˈsɑkər
chronicle=ˈkrɑnək(ə)l
movement=ˈmuvm(ə)nt
participate=pɑrˈtɪsᵻˌpeɪt
what=(h)wət
thanksgiving=ˌθæŋksˈɡɪvɪŋ
iraqi=ɪˈrɑki
shop=ʃɑp
mainland=ˈmeɪnˌlænd
hydraulic=haɪˈdrɔlɪk
sharp=ʃɑrp
pig-hunter=ˈpɪɡ ˌ(h)ən(t)ər
josh=dʒɑʃ
photograph=ˈfoʊdəˌɡræf
stocking=ˈstɑkɪŋ
september=sɛpˈtɛmbər
competitor=kəmˈpɛdədər
oxide=ˈɑkˌsaɪd
cancellation=ˌkæn(t)səˈleɪʃən
preference=ˈprɛf(ə)rən(t)s
carrier=ˈkɛriər
frontier=ˌfrənˈtɪ(ə)r
explain=ᵻkˈspleɪn
civilian=səˈvɪljən
contemporary=kənˈtɛmpəˌrɛri
mozambique=ˌmoʊzæmˈbik
mitchell=ˈmɪtʃ(ə)l
easily=ˈiz(ə)li
bargain=ˈbɑrɡ(ə)n
immigrant=ˈɪməɡrənt
peninsula=pəˈnɪn(t)s(ə)lə
call=kɔl
publish=ˈpəblɪʃ
litigation=ˌlɪdəˈɡeɪʃən
celtium=ˈsɛltiəm
naval=ˈneɪv(ə)l
fruit=frut
nil=nil
glagol=ˈɡlæɡ(ə)l
container=kənˈteɪnər
funding=ˈfəndɪŋ
gilbert=ˈɡɪlbərt
says=sɛz
discussion=dᵻˈskəʃən
beverage=ˈbɛv(ə)rɪdʒ
citizen=ˈsɪdᵻz(ə)n
cry=kraɪ
two=tu
strange=streɪndʒ
audile=ˈɔˌdaɪl
former=ˈfɔrmər
describe=dəˈskraɪb
ballet=bæˈleɪ
venice=ˈvɛnəs
convince=kənˈvɪn(t)s
shakespeare=ˈʃeɪkˌspɪ(ə)r
advantage=ədˈvæn(t)ɪdʒ
goal=ɡoʊl
completion=kəmˈpliʃən
absolutely=ˈæbsəˌl(j)utli
dougla=ˈdʊɡlə
behavioural=bəˈheɪvjərəl
creative=kriˈeɪdɪv
pond=pɑnd
metallic=məˈtælɪk
template=ˈtɛmplət
log-in=ˈlɔɡˌɪn
junk=dʒəŋk
wild=waɪld
projection=prəˈdʒɛkʃən
spider=ˈspaɪdər
forbid=fərˈbɪd
carry=ˈkɛri
railroad=ˈreɪlˌroʊd
rebecca=rəˈbɛkə
examination=ɪɡˌzæməˈneɪʃən
nam=nɑm
olympus=əˈlɪmpəs
restoration=ˌrɛstəˈreɪʃən
memo=ˈmɛmoʊ
supplemental=ˌsəpləˈmɛn(t)l
include=ᵻnˈklud
breakfast=ˈbrɛkfəst
boto=ˈboʊˌtoʊ
voip=vɔɪp
lithuanian=ˌlɪθəˈweɪniən
assumption=əˈsəm(p)ʃən
grill=ɡrɪl
garage=ɡəˈrɑʒ
equip=əˈkwɪp
merchandise=ˈmərtʃənˌdaɪz
semester=səˈmɛstər
charger=ˈtʃɑrdʒər
enclosure=ɛnˈkloʊʒər
mistake=məˈsteɪk
world=wərld
laptop=ˈlæpˌtɑp
doeth=ˈduəθ
century=ˈsɛn(t)ʃ(ə)ri
lesson=ˈlɛsən
substitute=ˈsəbstəˌt(j)ut
darkness=ˈdɑrknəs
transmission=trænzˈmɪʃən
sally=ˈsæli
metropolitan=ˌmɛtrəˈpɑlətn
stock=stɑk
should=ʃʊd
within=wəˈðɪn
reflect=rəˈflɛk(t)
assign=əˈsaɪn
previously=ˈpriviəsli
manually=ˈmænjə(wə)li
authority=ɔˈθɔrədi
guilty=ˈɡɪlti
tar=tɑr
gear=ɡɪ(ə)r
transition=trænˈzɪʃən
intranet=ˈɪntrəˌnɛt
dying=ˈdaɪɪŋ
showtime=ˈʃoʊˌtaɪm
welfare=ˈwɛlˌfɛ(ə)r
morocco=məˈrɑkoʊ
hospital=ˈhɑˌspɪd(ə)l
knit=nɪt
mailo=ˈmaɪloʊ
ethical=ˈɛθəkəl
purchase=ˈpərtʃəs
grace=ɡreɪs
sayest=ˈseɪəst
reader=ˈridər
engineering=ˌɛndʒəˈnɪrɪŋ
springer=ˈsprɪŋər
kid=kɪd
guru=ˈɡʊˌru
party=ˈpɑrdi
institute=ˈɪn(t)stəˌt(j)ut
sunset=ˈsənˌsɛt
tanzanian=ˌtænzəˈniən
rick=rɪk
memorabilia=ˌmɛm(ə)rəˈbiljə
heavily=ˈhɛvəli
desperate=ˈdɛsp(ə)rət
friendship=ˈfrɛn(d)ˌʃɪp
newark=ˈn(j)uwərk
jeffrey=ˈdʒɛfri
need=nid
fun=fən
exception=ᵻkˈsɛpʃən
denver=ˈdɛnvər
hobby=ˈhɑbi
asylum=əˈsaɪləm
atheism=ˈeɪθiˌɪzəm
beach=bitʃ
stylish=ˈstaɪlɪʃ
utile=ˈjudl
next=nɛkst
homeland=ˈhoʊmˌlænd
suppose=səˈpoʊz
represent=ˌrɛprəˈzɛnt
chile=ˈtʃɪliː
yahoo=ˈjɑˌhu
ing=ɪŋ
quebec=k(w)əˈbɛk
democrat=ˈdɛməˌkræt
polyester=ˌpɑliˈɛstər
webcast=ˈwɛbˌkæst
jon=dʒɑn
park=pɑrk
gospel=ˈɡɑsp(ə)l
pig=pɪɡ
dis=dɪs
constitution=ˌkɑn(t)stəˈt(j)uʃən
ladder=ˈlædər
respective=rəˈspɛktɪv
professor=prəˈfɛsər
fashion=ˈfæʃən
cire=ˈsiːreɪ
nato=ˈneɪdoʊ
salmon=ˈsæmən
machine=məˈʃin
orleans=ˈɔrlənz
madonna=məˈdɑnə
win=wɪn
induction=ᵻnˈdəkʃən
bracket=ˈbrækət
hazard=ˈhæzərd
ranch=ræn(t)ʃ
lawyer=ˈlɔɪər
shortly=ˈʃɔrtli
colleague=ˈkɑliɡ
ananda=ɑˈnɑndə
austin=ˈɔstən
tsunami=tsuːˈnɑːmi
buffer=ˈbəfər
natural=ˈnætʃər(ə)l
capability=ˌkeɪpəˈbɪlᵻdi
emission=əˈmɪʃən
cultural=ˈkəltʃ(ə)rəl
rice=raɪs
nascar=ˈnæsˌkɑr
canon=ˈkænən
sms=ˌɛsɛmˈɛs
jazz=dʒæz
tie=taɪ
ethics=ˈɛθɪks
hotel=hoʊˈtɛl
latin=ˈlætn
lightweight=ˈlaɪtˌweɪt
present=priˈzɛnt
effectiveness=əˈfɛktɪvnᵻs
ada=ˌeɪˌdiˈeɪ
array=əˈreɪ
bacon=ˈbeɪkən
regularly=ˈrɛɡ(jə)lərli
sunday=ˈsənˌdeɪ
fantasy=ˈfæntəsɪ
less=lɛs
airport=ˈɛrˌpɔrt
dash=dæʃ
powerful=ˈpaʊ(ə)rf(ə)l
wallet=ˈwɑlət
investigate=ᵻnˈvɛstəˌɡeɪt
xerox=ˈziˌrɑks
kingston=ˈkɪŋstən
donation=doʊˈneɪʃən
positive=ˈpɑzədɪv
panties=ˈpæn(t)iz
portable=ˈpɔrdəb(ə)l
sensitive=ˈsɛn(t)sədɪv
reload=riˈloʊd
arabic=ˈɛrəbɪk
sociology=ˌsoʊsiˈɑlədʒi
beside=bəˈsaɪd
doctor=ˈdɑktər
tragedy=ˈtrædʒədi
june=dʒun
strict=strɪk(t)
quote=kwoʊt
year=jɪ(ə)r
antivirus=ˌænˌtaɪˈvaɪrəs
chart=tʃɑrt
freedom=ˈfridəm
cursor=ˈkərsər
purse=pərs
attribute=əˈtrɪˌbjut
relocation=ˌriloʊˈkeɪʃən
betty=ˈbɛdi
insurance=ᵻnˈʃʊrən(t)s
acne=ˈækni
panax=ˈpænæks
margaret=ˈmɑrɡrət
shit=ʃɪt
ride=raɪd
gordon=ˈɡɔːdən
software=ˈsɔf(t)ˌwɛ(ə)r
talented=ˈtælən(t)əd
alpine=ˈælˌpaɪn
player=ˈpleɪər
trade=treɪd
hungry=ˈhəŋɡri
epic=ˈɛpɪk
shareware=ˈʃɛrˌwɛ(ə)r
facility=fəˈsɪlᵻdi
horny=ˈhɔrni
marial=ˈmɛriəl
wedding=ˈwɛdɪŋ
mambo=ˈmɑmboʊ
legally=ˈliɡəli
thank=θæŋk
breathe=brið
hypothesis=haɪˈpɑθəsəs
bandwidth=ˈbæn(d)ˌwɪdθ
aria=ˈɑriə
fur=fər
processing=ˈprɑˌsɛsɪŋ
reveal=rəˈvil
anthony=ˈænθəni
connect=kəˈnɛk(t)
address=əˈdrɛs
flux=fləks
goat=ɡoʊt
whale=(h)weɪl
quit=kwɪt
hood=hʊd
zip=zɪp
portrait=ˈpɔrtrət
your=jʊ(ə)r
renewal=rəˈn(j)uəl
underwear=ˈəndərˌwɛ(ə)r
cisco=ˈsɪskoʊ
harassment=həˈræsm(ə)nt
execution=ˌɛksəˈkjuʃən
mpeg=ˈɛmˌpɛɡ
fraud=frɔd
trash=træʃ
pill=pɪl
vega=ˈveɪɡə
situation=ˌsɪtʃəˈweɪʃən
heritage=ˈhɛrədɪdʒ
capitol=ˈkæpədl
pasta=ˈpɑstə
wallace=ˈwɔləs
admin=ˈædˌmɪn
expression=ᵻkˈsprɛʃən
personnel=ˌpərsnˈɛl
yearly=ˈjɪrli
ask=æsk
our=ˈaʊ(ə)r
toll=toʊl
hope=hoʊp
valentine=ˈvælənˌtaɪn
likewise=ˈlaɪkˌwaɪz
usual=ˈjuʒ(əw)əl
idol=ˈaɪd(ə)l
export=ˈɛkˌspɔrt
off=ɔf
thread=θrɛd
wise=waɪz
ban=bæn
remarkable=rəˈmɑrkəb(ə)l
urb=ərb
that=ðæt
mobility=moʊˈbɪlᵻdi
cypress=ˈsaɪprəs
compete=kəmˈpit
recycle=riˈsaɪk(ə)l
magnificent=mæɡˈnɪfəsənt
promise=ˈprɑməs
hometown=ˈhoʊmˌtaʊn
soma=ˈsoʊmə
dictionary=ˈdɪkʃəˌnɛri
mile=maɪl
hide=haɪd
tool=tul
co=koʊ
larry=ˈlɛri
bedroom=ˈbɛdˌrum
jam=dʒæm
nearby=ˌnɪrˈbaɪ
candy=ˈkændi
rail=reɪl
determine=dəˈtərmən
chair=tʃɛ(ə)r
appliance=əˈplaɪən(t)s
amber=ˈæmbər
grove=ɡroʊv
sir=sər
prospective=prəˈspɛktɪv
observation=ˌɑbzərˈveɪʃən
roughly=ˈrəfli
hierarchy=ˈhaɪ(ə)ˌrɑrki
cannot=kəˈnɑt
redhead=ˈrɛdˌ(h)ɛd
hough=hu
instant=ˈɪn(t)st(ə)nt
pakistani=ˌpækəˈstæni
partially=ˈpɑrʃəli
fist=fɪst
bible=ˈbaɪb(ə)l
fili=ˈfɪli
politician=ˌpɑləˈtɪʃən
frost=frɔst
abject=ˈæbˌdʒɛk(t)
thereof=ðɛˈrɑv
act=æk(t)
schedule=ˈskɛˌdʒul
misplace=ˌmɪsˈpleɪs
murder=ˈmərdər
coyote=ˈkaɪoʊt
not=nɑt
she-male=ˈʃiˌmeɪl
influence=ˈɪnflʊən(t)s
diva=ˈdiːva
dedicated=ˈdɛdəˌkeɪdᵻd
photo=ˈfoʊdoʊ
roman=ˈroʊmən
rise=raɪz
temple=ˈtɛmp(ə)l
inform=ᵻnˈfɔrm
provide=prəˈvaɪd
garden=ˈɡɑrdən
mahoe=məˈhoʊ
sponsor=ˈspɑn(t)sər
passenger=ˈpæsndʒər
bat=bæt
funeral=ˈfjun(ə)rəl
rep=rɛp
construction=kənˈstrəkʃən
travel=ˈtræv(ə)l
card=kɑrd
stuart=ˈst(j)uərt
try=traɪ
bobby=ˈbɑbi
claim=kleɪm
garbage=ˈɡɑrbɪdʒ
chemistry=ˈkɛməstri
immunology=ˌɪmjəˈnɑlədʒi
messenger=ˈmɛsndʒər
cannon=ˈkænən
contributor=kənˈtrɪbjudər
frequent=ˈfrikwənt
madness=ˈmædnəs
everly=ˈɛvərli
quiz=kwɪz
scary=ˈskɛri
blog=blɔɡ
mesa=ˈmeɪsə
depth=dɛpθ
volt=voʊlt
extent=ɪkˈstɛnt
dost=dəst
cue=kju
emblem=ˈɛmbləm
vast=væst
proceed=prəˈsid
often=ˈɔf(ə)n
hawaiian=həˈwaɪ(j)ən
analyse=ˈænlˌaɪz
reproduction=ˌriprəˈdəkʃən
shirt=ʃərt
securely=səˈkjʊrli
diet=ˈdaɪət
olein=ˈoʊliən
estate=əˈsteɪt
calibration=ˌkæləˈbreɪʃən
firmware=ˈfərmˌwɛ(ə)r
alban=ˈɑlbən
same=seɪm
did=dɪd
kent=kɛnt
electric=əˈlɛktrɪk
you=ju
follow=ˈfɑloʊ
phone=foʊn
margin=ˈmɑrdʒən
revision=rəˈvɪʒ(ə)n
land=lænd
virtually=ˈvərtʃ(əw)əli
zope=zəʊp
arrange=əˈreɪndʒ
lab=læb
mercury=ˈmərkjəri
aerial=ˈɛriəl
formula=ˈfɔrmjələ
elsewhere=ˈɛlsˌ(h)wɛr
kilometre=kᵻˈlɑmədər
friendly=ˈfrɛn(d)li
pavilion=pəˈvɪlj(ə)n
controversy=ˈkɑntrəˌvərsi
exactly=ɪɡˈzæk(t)li
feedback=ˈfidˌbæk
impose=ᵻmˈpoʊz
bail=beɪl
embassy=ˈɛmbəsi
golf=ɡɔlf
writing=ˈraɪdɪŋ
narrative=ˈnɛrədɪv
pottery=ˈpɑdəri
offering=ˈɔfərɪŋ
quantity=ˈkwɑn(t)ədi
oxford=ˈɑksfərd
collar=ˈkɑlər
hell=hɛl
refund=ˈriˌfənd
art=ɑrt
while=(h)waɪl
commission=kəˈmɪʃən
classroom=ˈklæsˌrum
gotta=ˈɡɑdə
meyer=ˈmaɪər
new=n(j)u
topic=ˈtɑpɪk
boot=but
indiana=ˌɪndiˈænə
lecture=ˈlɛk(t)ʃər
brunette=bruˈnɛt
talk=tɔk
both=boʊθ
guardian=ˈɡɑrdiən
mighty=ˈmaɪdi
tiki=ˈtɪki
but=bət
certify=ˈsərdəˌfaɪ
foam=foʊm
operate=ˈɑpəˌreɪt
cotton=ˈkɑtn
diary=ˈdaɪ(ə)ri
approximately=əˈprɑksəmətli
rally=ˈræli
eld=ɛld
mediterranean=ˌmɛdətəˈreɪniən
finance=ˈfaɪˌnæn(t)s
concrete=ˈkɑnˌkrit
arrival=əˈraɪvəl
byte=baɪt
maternity=məˈtərnədi
effectively=əˈfɛktəvli
up=əp
drawing=ˈdrɔɪŋ
grad=ɡræd
cambridge=ˈkeɪmˌbrɪdʒ
treasury=ˈtrɛʒ(ə)ri
specialized=ˈspɛʃəˌlaɪzd
review=rəˈvju
maybe=ˈmeɪbi
goeth=ˈɡoʊəθ
closure=ˈkloʊʒər
cork=kɔrk
visible=ˈvɪzəb(ə)l
jeans=dʒinz
director=dəˈrɛktər
recommend=ˌrɛkəˈmɛnd
parameter=pəˈræmədər
detailed=dəˈteɪld
strong=strɔŋ
discovery=dᵻˈskəv(ə)ri
mobbie=ˈmɑbi
cop=kɑp
rank=ræŋk
firewire=ˈfaɪ(ə)rˌwaɪ(ə)r
another=əˈnəðər
ready=ˈrɛdi
newly=ˈn(j)uli
thorough=ˈθərə
decline=dəˈklaɪn
trailer=ˈtreɪlər
trial=ˈtraɪ(ə)l
bush=bʊʃ
bailey=ˈbeɪli
deeply=ˈdipli
wireless=ˈwaɪ(ə)rləs
documentary=ˌdɑkjəˈmɛnt(ə)ri
lot=lɑt
reproduce=ˌriprəˈd(j)us
desirable=dəˈzaɪrəb(ə)l
spell=spɛl
threesome=ˈθris(ə)m
chuck=tʃək
navigation=ˌnævəˈɡeɪʃən
alphabetical=ˌælfəˈbɛdəkəl
regulate=ˈrɛɡjəˌleɪt
assurance=əˈʃʊrən(t)s
wholesale=ˈhoʊlˌseɪl
boom=bum
rosha=ˈroʊʃə
shield=ʃild
bitch=bɪtʃ
cassette=kəˈsɛt
continue=kənˈtɪnju
strengthen=ˈstrɛŋ(k)θ(ə)n
residential=ˌrɛzəˈdɛn(t)ʃ(ə)l
expire=ɪkˈspaɪ(ə)r
promote=prəˈmoʊt
deadly=ˈdɛdli
research=ˈriˌsərtʃ
olive=ˈɑləv
dead=dɛd
cylinder=ˈsɪləndər
voyeur=vɔɪˈjər
motivation=ˌmoʊdəˈveɪʃən
library=ˈlaɪˌbrɛri
enemy=ˈɛnəmi
rocky=ˈrɑki
christopher=ˈkrɪstəfər
suggest=sə(ɡ)ˈdʒɛst
liverpool=ˈlɪvərˌpul
hardcover=ˈhɑrdˌkəvər
strongly=ˈstrɔŋli
belike=bəˈlaɪk
bason=ˈbeɪs(ə)n
assistance=əˈsɪst(ə)n(t)s
remainder=rəˈmeɪndər
crap=kræp
hardly=ˈhɑrdli
yield=jild
pixel=ˈpɪks(ə)l
calculator=ˈkælkjəˌleɪdər
entrepreneur=ˌɑntrəprəˈn(j)ʊ(ə)r
ink=ɪŋk
nirvana=nərˈvɑnə
lean=lin
regular=ˈrɛɡ(jə)lər
designate=ˈdɛzɪɡˌneɪt
amateur=ˈæmədər
yesses=ˈjɛsəz
cidaris=ˈsɪdərɪs
go=ɡoʊ
unavailable=ˌənəˈveɪləb(ə)l
assume=əˈsum
communist=ˈkɑmjənəst
diversity=dəˈvərsədi
victorian=vɪkˈtɔriən
baseball=ˈbeɪsˌbɔl
luck=lək
utility=juˈtɪlədi
genre=ˈʒɑnrə
bedford=ˈbɛdfərd
antarctical=ænˈ(t)ɑrktək(ə)l
sick=sɪk
howe'er=haʊˈɛ(ə)r
arbitrary=ˈɑrbəˌtrɛri
money=ˈməni
conference=ˈkɑnf(ə)rən(t)s
discover=dᵻˈskəvər
satisfaction=ˌsædəsˈfækʃən
syndication=sɪndɪˈkeɪʃən
lyric=ˈlɪrɪk
defence=dəˈfɛn(t)s
joshua=ˈdʒɑʃ(ə)wə
compile=kəmˈpaɪl
adopt=əˈdɑpt
athletic=æθ(ə)ˈlɛdɪk
halifax=ˈhalɪfaks
payment=ˈpeɪm(ə)nt
mine=maɪn
walt=wɒlt
whate'er=(h)wəˈtɛr
bevin=ˈbɛvən
afterwards=ˈæftərwərdz
outer=ˈaʊdər
tappa=ˈtɑpə
october=ɑkˈtoʊbər
struct=strək(t)
tin=tɪn
country=ˈkəntri
agent=ˈeɪdʒ(ə)nt
breed=brid
playboy=ˈpleɪˌbɔɪ
registration=ˌrɛdʒəˈstrəɪʃən
terrorism=ˈtɛrəˌrɪzəm
cingular=ˈsɪŋɡjuːlə
lazy=ˈleɪzi
russia=ˈrəʃə
refugee=ˌrɛfjəˈdʒi
glucose=ˈɡluˌkoʊs
rec=rɛk
check-out=ˈtʃɛkˌaʊt
belgium=ˈbɛldʒəm
dad=dæd
gone=ɡɔn
vital=ˈvaɪd(ə)l
overall=ˈoʊvəˌrɔl
collaborative=kəˈlæbərədɪv
bright=braɪt
offshore=ˈɔfˌʃɔr
outcome=ˈaʊtˌkəm
tax=tæks
mountain=ˈmaʊnt(ə)n
people=ˈpip(ə)l
nearly=ˈnɪrli
organization=ˌɔrɡənəˈzeɪʃən
come=kəm
griffin=ˈɡrɪfɪn
reproductive=ˌriprəˈdəktɪv
heath=hiθ
note=noʊt
refuse=rəˈfjuz
hello=həˈloʊ
caribbean=ˌkɛrəˈbiən
whore=hɔr
skirt=skərt
misc=mɪsk
nebraskan=nəˈbræsk(ə)n
east=ist
jessie=ˈdʒɛsi
theorem=ˈθiərəm
ruby=ˈrubi
refrigerator=rəˈfrɪdʒəˌreɪdər
duration=d(j)ʊrˈeɪʃən
norm=nɔrm
step=stɛp
momentum=moʊˈmɛn(t)əm
german=ˈdʒərmən
withdrawal=wɪðˈdrɔ(ə)l
derby=ˈdərbi
clip=klɪp
neighbourhood=ˈneɪbərˌ(h)ʊd
submit=səbˈmɪt
marie=məˈri
resort=rəˈzɔrt
mixer=ˈmɪksər
in-line=ˈɪnˌlaɪn
argue=ˈɑrɡju
georgia=ˈdʒɔrdʒə
environmental=ənˌvaɪrə(n)ˈmɛn(t)l
representative=ˌrɛprəˈzɛn(t)ədɪv
landscape=ˈlæn(d)ˌskeɪp
poem=ˈpoʊ(ə)m
handbag=ˈhæn(d)ˌbæɡ
thirty=ˈθərdi
several=ˈsɛv(ə)rəl
differently=ˈdɪf(ə)rəntli
anger=ˈæŋɡər
analysis=əˈnæləsəs
flood=fləd
dial=ˈdaɪ(ə)l
nurse=nərs
parallel=ˈpɛrəˌlɛl
switch=swɪtʃ
embed=əmˈbɛd
anybody=ˈɛniˌbɑdi
co-ordinate=koʊˈɔrdəˌneɪt
playback=ˈpleɪˌbæk
unified=ˈjunəˌfaɪd
swiss=swɪs
constantly=ˈkɑn(t)st(ə)n(t)li
schema=ˈskimə
got=ɡɑt
sake=seɪk
modification=ˌmɑdəfəˈkeɪʃən
chick=tʃɪk
forecast=ˈfɔrˌkæst
techno=ˈtɛknoʊ
decade=ˈdɛˌkeɪd
donna=ˈdɑnə
yukon=ˈjuˌkɑn
nevertheless=ˌnɛvərðəˈlɛs
dual=ˈd(j)uəl
holding=ˈhoʊldɪŋ
forward=ˈfɔrwərd
prepare=priˈpɛ(ə)r
kansa=ˈkanzə
eat=it
imply=ᵻmˈplaɪ
seriously=ˈsɪriəsli
taxation=tækˈseɪʃən
unlike=ˌənˈlaɪk
participant=pɑrˈtɪsᵻp(ə)nt
possess=pəˈzɛs
rap=ræp
hebrew=ˈhiˌbru
planner=ˈplænər
popular=ˈpɑpjələr
thompson=ˈtɑm(p)sən
ticket=ˈtɪkᵻt
paraguay=ˈpɛrəˌɡwaɪ
chinese=ˌtʃaɪˈniz
day=deɪ
worst=wərst
danish=ˈdeɪnɪʃ
mysterious=məˈstɪriəs
platform=ˈplætˌfɔrm
pam=pæm
iceland=ˈaɪslənd
designer=dəˈzaɪnər
motorcycle=ˈmoʊdərˌsaɪk(ə)l
melbournite=ˈmɛlbərˌnaɪt
why=(h)waɪ
chorus=ˈkɔrəs
polymer=ˈpɑləmər
whene'er=(h)wəˈnɛ(ə)r
prairie=ˈprɛri
optional=ˈɑpʃən(ə)l
poster=ˈpoʊstər
creation=kriˈeɪʃən
volunteer=ˌvɑlənˈtɪ(ə)r
brant=brænt
concentrate=ˈkɑn(t)sənˌtreɪt
explicitly=ᵻkˈsplɪsᵻtli
material=məˈtɪriəl
lick=lɪk
canyon=ˈkænjən
ca=kɔ
sexually=ˈsɛkʃ(əw)əli
eligibility=ˌɛlədʒəˈbɪlᵻdi
cordless=ˈkɔːdlɪs
baptist=ˈbæptəst
detective=dəˈtɛktɪv
grenadan=ɡrəˈneɪd(ə)n
let=lɛt
terrorist=ˈtɛrərəst
logo=ˈloʊɡoʊ
javascript=ˈdʒɑvəˌskrɪp(t)
sort=sɔrt
certainly=ˈsərtnli
christianity=ˌkrɪst(ʃ)iˈænədi
however=haʊˈɛvər
core=kɔr
florist=ˈflɔrəst
magazine=ˈmæɡəˌzin
accordingly=əˈkɔrdɪŋli
patch=pætʃ
dynamic=daɪˈnæmɪk
regulatory=ˈrɛɡjələˌtɔri
february=ˈfɛb(j)əˌwɛri
defendant=dəˈfɛnd(ə)nt
minimal=ˈmɪnəm(ə)l
rome=roʊm
social=ˈsoʊʃ(ə)l
lafayette=ˌlɑfiˈ(j)ɛt
worcester=ˈwʊstər
foster=ˈfɔstər
judgement=ˈdʒədʒmənt
between=bəˈtwin
cowboy=ˈkaʊˌbɔɪ
berry=ˈbɛri
workforce=ˈwərkˌfɔrs
kinda=ˈkaɪndə
boulton=ˈbəʊltən
clean=klin
reach=ritʃ
snapshot=ˈsnæpˌʃɑt
composition=ˌkɑmpəˈzɪʃən
discrete=dᵻˈskrit
guinea=ˈɡɪni
build=bɪld
deadline=ˈdɛdˌlaɪn
idaho=ˈaɪdəˌhoʊ
favourite=ˈfeɪv(ə)rᵻt
liability=ˌlaɪəˈbɪlᵻdi
paragraph=ˈpɛrəˌɡræf
algid=ˈældʒɪd
bring=brɪŋ
australian=ɔˈstreɪljən
victor=ˈvɪktər
family=ˈfæm(ə)li
aka=ˌeɪkeɪˈeɪ
express=ᵻkˈsprɛs
runner=ˈrənər
yet=jɛt
technician=tɛkˈnɪʃən
doctrine=ˈdɑktrən
cathedral=kəˈθidrəl
innocent=ˈɪnəs(ə)nt
assist=əˈsɪst
advice=ədˈvaɪs
cookbook=ˈkʊkˌbʊk
theft=θɛft
surprise=sə(r)ˈpraɪz
com=kɑm
staffs=stæfs
marker=ˈmɑrkər
abox=əˈbɑks
don=dɑn
timely=ˈtaɪmli
precede=priˈsid
gen=dʒɛn
amply=ˈæmp(ə)li
absolute=ˈæbsəˌlut
porter=ˈpɔrdər
ruth=ruθ
sunglasses=ˈsənˌɡlæsəz
gateway=ˈɡeɪtˌweɪ
nhs=ˌɛnˌeɪtʃˈɛs
bath=bæθ
result=rəˈzəlt
laundry=ˈlɔndri
mauritian=mɔˈrɪʃən
listing=ˈlɪstɪŋ
sexuality=ˌsɛkʃəˈwælədi
therapist=ˈθɛrəpəst
outstanding=ˌaʊtˈstændɪŋ
president=ˈprɛz(ə)dnt
brix=brɪks
coast=koʊst
extract=ɪkˈstrækt
pursuit=pərˈs(j)ut
promotion=prəˈmoʊʃən
decide=dəˈsaɪd
legislature=ˈlɛdʒəˌsleɪtʃər
atol=ˈæˌtɔl
iso=ˈaɪsoʊ
kodak=ˈkoʊˌdæk
policy=ˈpɑləsi
watson=ˈwɑts(ə)n
affiliation=əˌfɪliˈeɪʃən
amendment=əˈmɛn(d)mənt
manage=ˈmænɪdʒ
ass=æs
wang=wæŋ
sky=skaɪ
discipline=ˈdɪsəplən
credit=ˈkrɛdət
devil=ˈdɛvəl
inquiry=ˈɪnˌkwaɪri
hop=hɑp
yes=jɛs
pose=poʊz
textbook=ˈtɛks(t)ˌbʊk
appropriation=əˌproʊpriˈeɪʃən
rna=ˌɑrˌɛnˈeɪ
blanket=ˈblæŋkət
generic=dʒəˈnɛrɪk
corp=ˈkɔːp
sword=sɔrd
interracial=ˌɪn(t)ərˈreɪʃ(ə)l
spoke=spoʊk
operator=ˈɑpəˌreɪdər
editor=ˈɛdədər
patrician=pəˈtrɪʃən
milan=məˈlɑn
jar=dʒɑr
terek=ˈtɛrɪk
manchester=ˈmæntʃəstər
conceptual=kənˈsɛp(t)ʃ(əw)əl
legitimate=ləˈdʒɪdəmət
roommate=ˈru(m)ˌmeɪt
accredit=əˈkrɛdət
Phoenicis=fiˈnɪsɪs
antique=ænˈtik
earl=ˈər(ə)l
boolean=ˈbuliən
somewhere=ˈsəmˌ(h)wɛ(ə)r
lifestyle=ˈlaɪfˌstaɪl
birmingham=ˈbərmɪŋˌhæm
insider=ᵻnˈsaɪdər
plaintiff=ˈpleɪn(t)ᵻf
royalty=ˈrɔɪ(ə)lti
somewhat=ˈsəmˌ(h)wɑt
e-commerce=ˈiˌkɑmərs
email=ˈiˌmeɪl
dump=dəmp
angel=ˈeɪndʒəl
fog=fɔɡ
redeem=rəˈdim
payable=ˈpeɪəb(ə)l
israel=ˈɪzriəl
soap=soʊp
adequate=ˈædəkwət
attraction=əˈtrækʃən
circumstance=ˈsərkəmˌstæns
electronics=əˌlɛkˈtrɑnɪks
freen=friːn
parental=pəˈrɛn(t)l
zoophilia=ˌzu(ə)ˈfɪljə
alloy=ˈæˌlɔɪ
renew=rəˈn(j)u
pledge=plɛdʒ
freight=freɪt
stuff=stəf
validation=ˌvæləˈdeɪʃən
intention=ᵻnˈtɛn(t)ʃən
substance=ˈsəbstən(t)s
outreach=ˈaʊtˌritʃ
reel=ril
village=ˈvɪlɪdʒ
jurisdiction=ˌdʒʊrəsˈdɪkʃən
norwegian=nɔrˈwidʒ(ə)n
share=ʃɛ(ə)r
trend=trɛnd
essential=əˈsɛn(t)ʃ(ə)l
maui=ˈmaʊi
they=ðeɪ
shopping=ˈʃɑpɪŋ
bless=blɛs
clean-up=ˈklinˌəp
compliant=kəmˈplaɪənt
ensure=ᵻnˈʃʊ(ə)r
as=æz
tier=tɪ(ə)r
died=daɪd
fiction=ˈfɪkʃən
trip=trɪp
tolerance=ˈtɑl(ə)rən(t)s
one=wən
chem=kɛm
tag=tæɡ
morache=məˈrɑtʃeɪ
durham=ˈdərəm
came=keɪm
ripe=raɪp
parker=ˈpɑrkər
apply=əˈplaɪ
microdont=ˈmaɪkroʊˌdɑnt
hair=hɛ(ə)r
faith=feɪθ
chicago=ʃɪˈkɑɡoʊ
deny=dəˈnaɪ
stake=steɪk
boutique=buˈtik
revenue=ˈrɛvəˌn(j)u
novae=ˈnoʊvi
partly=ˈpɑrtli
fragrance=ˈfreɪɡrən(t)s
sign-up=ˈsaɪnˌəp
noon=nun
batch=bætʃ
alaska=əˈlæskə
trim=trɪm
sic=sɪk
phillips=ˈfɪlᵻps
conflict=ˈkɑnˌflɪk(t)
prize=praɪz
bike=baɪk
conversation=ˌkɑnvərˈseɪʃən
equipment=əˈkwɪpmənt
relay=ˈriˌleɪ
rider=ˈraɪdər
expenditure=ɪkˈspɛndətʃər
precision=priˈsɪʒ(ə)n
eagle=ˈiɡəl
champion=ˈtʃæmpiən
advisor=ədˈvaɪzər
informative=ᵻnˈfɔrmədɪv
silicon=ˈsɪləˌkɑn
squad=skwɑd
miller=ˈmɪlər
traditional=trəˈdɪʃ(ə)nəl
employment=ᵻmˈplɔɪm(ə)nt
spattle=ˈspat(ə)l
stamp=stæmp
shikara=ʃᵻˈkɑːrə
saturn=ˈsædərn
info=ˈɪnfoʊ
socket=ˈsɑkət
cologne=kəˈloʊn
cruise=kruz
metric=ˈmɛtrɪk
tutorial=t(j)uˈtɔriəl
keep=kip
accreditation=əˌkrɛdəˈteɪʃən
profession=prəˈfɛʃən
by-lane=ˈbʌɪˌleɪn
taylor=ˈteɪlər
omega=oʊˈmeɪɡə
insect=ˈɪnˌsɛk(t)
define=dəˈfaɪn
safari=səˈfɑri
river=ˈrɪvər
carol=ˈkɛrəl
optimization=ˌɑptəməˈzeɪʃən
turkey=ˈtərki
gazette=ɡəˈzɛt
forest=ˈfɔrəst
finish=ˈfɪnᵻʃ
ringtone=ˈrɪŋˌtoʊn
polar=ˈpoʊlər
cinema=ˈsɪnəmə
incorrect=ˌɪnkəˈrɛk(t)
inspection=ᵻnˈspɛkʃən
numeric=n(j)uˈmɛrɪk
aboriginal=ˌæbəˈrɪdʒənl
this=ðɪs
relax=rəˈlæks
riverside=ˈrɪvərˌsaɪd
lucas=ˈlukəs
attorney=əˈtərni
mexican=ˈmɛksək(ə)n
nail=neɪl
lodge=lɑdʒ
repeat=rəˈpit
heather=ˈhɛðər
worse=wərs
neighbour=ˈneɪbər
alarm=əˈlɑrm
range=reɪndʒ
highlight=ˈhaɪˌlaɪt
allot=əˈlɑt
browse=braʊz
marketplace=ˈmɑrkətˌpleɪs
substantially=ˌsəbˈstæn(t)ʃəli
basis=ˈbeɪsəs
slovenian=sloʊˈviniən
trick=trɪk
orgy=ˈɔrdʒi
poetry=ˈpoʊətri
lesbian=ˈlɛzbiən
gamma=ˈɡæmə
jane=dʒeɪn
chess=tʃɛs
precise=priˈsaɪs
vision=ˈvɪʒən
consciousness=ˈkɑnʃəsnəs
awesome=ˈɔsəm
bikini=bᵻˈkini
dispute=dəˈspjut
maldivan=mɑlˈdivən
power=ˈpaʊ(ə)r
liquid=ˈlɪkwᵻd
plumb=pləm
mongolian=mɑŋˈɡoʊljən
blackberry=ˈblækˌbɛri
trivia=ˈtrɪviə
triumph=ˈtraɪəmf
lysol=ˈlaɪˌsɔl
wagner=ˈvɑɡnər
annotation=ˌænəˈteɪʃən
rational=ˈræʃ(ə)nəl
adoption=əˈdɑpʃən
bluetooth=ˈbluˌtuθ
undertake=ˌəndərˈteɪk
lang=læŋ
cuba=ˈkjubə
apparel=əˈpɛrəl
historic=hɪˈstɔrɪk
ami=ɑˈmi
algorithm=ˈælɡəˌrɪðəm
untitled=ˌənˈtaɪd(ə)ld
telson=ˈtɛlsən
madrina=məˈdrinə
function=ˈfəŋ(k)ʃən
headline=ˈhɛdˌlaɪn
sim=sɪm
moderator=ˈmɑdəˌreɪdər
dell=dɛl
yorkshire=ˈjɔrkˌʃɪ(ə)r
butler=ˈbətlər
sterling=ˈstərlɪŋ
builder=ˈbɪldər
whilst=(h)waɪlst
niagara=naɪˈæɡ(ə)rə
aye=eɪ
corporate=ˈkɔrp(ə)rət
weblog=ˈwɛbˌlɔɡ
habit=ˈhæbət
pioneer=ˌpaɪəˈnɪ(ə)r
geneva=dʒəˈnivə
adaptation=ˌædæpˈteɪʃən
fireplace=ˈfaɪ(ə)rˌpleɪs
time=taɪm
surge=sərdʒ
musician=mjuˈzɪʃən
display=dəˈspleɪ
renaissance=ˈrɛnəˌsɑn(t)s
interactive=ˌɪn(t)ərˈæktɪv
jonathan=ˈdʒɑnəθən
brought=brɔt
doth=dəθ
copy=ˈkɑpi
abroad=əˈbrɔd
snake=sneɪk
editorial=ˌɛdəˈtɔriəl
marketing=ˈmɑrkədɪŋ
boat=boʊt
rout=raʊt
proof=pruf
fountain=ˈfaʊnt(ə)n
statement=ˈsteɪtmənt
tit=tɪt
hash=hæʃ
new-man=ˌn(j)u ˈmæn
salt=sɔlt
corporation=ˌkɔrpəˈreɪʃən
debate=dəˈbeɪt
helmet=ˈhɛlmət
authorization=ˌɔθərəˈzeɪʃən
governor=ˈɡəv(ə)nər
coach=koʊtʃ
gregory=ˈɡrɛɡəri
transit=ˈtrænzət
democratic=ˌdɛməˈkrædɪk
brandis=ˈbrændəs
pillow=ˈpɪloʊ
consequence=ˈkɑn(t)səkwən(t)s
hurt=hərt
leu=ˌɛlˌiˈju
chancellor=ˈtʃæn(t)s(ə)lər
subscribe=səbˈskraɪb
against=əˈɡɛn(t)st
pursuant=pərˈs(j)uənt
prospect=ˈprɑˌspɛk(t)
caught=kɔt
earth=ərθ
webley=ˈwɛbli
draw=drɔ
achievement=əˈtʃivm(ə)nt
despite=dəˈspaɪt
practice=ˈpræktəs
oct=ɑk(t)
counter=ˈkaʊn(t)ər
raw=rɔ
funk=fəŋk
fence=fɛn(t)s
serious=ˈsɪriəs
men=mɛn
bedfast=ˈbɛdˌfæst
stable=ˈsteɪb(ə)l
atmospheric=ˌætməsˈfɪrɪk
conspiracy=kənˈspɪrᵻsi
hole=hoʊl
invitation=ˌɪnvəˈteɪʃən
latina=ləˈtinə
processor=ˈprɑˌsɛsər
warner=ˈwɔrnər
municipal=mjuˈnɪsəp(ə)l
span=spæn
engineer=ˌɛndʒəˈnɪ(ə)r
tosh=tɔʃ
croatian=kroʊˈeɪʃən
bibliography=ˌbɪbliˈɑɡrəfi
flasher=ˈflæʃər
phil=fɪl
free-kick=fri ˈkɪk
most=moʊst
unable=ˌənˈeɪb(ə)l
temporary=ˈtɛmpəˌrɛri
bend=bɛnd
cube=kjub
tea=ti
bermuda=bərˈmjudə
bench=bɛn(t)ʃ
factory=ˈfækt(ə)ri
team=tim
lookup=ˈlʊkˌəp
synthetic=sɪnˈθɛdɪk
vulnerability=ˌvəln(ə)rəˈbɪlᵻdi
fancy=ˈfænsɪ
powder=ˈpaʊdər
micro=ˈmaɪkroʊ
grand=ɡrænd
missouri=məˈzʊri
futah=ˈfuːta
marplan=ˈmɑrˌplæn
thought=θɔt
reed=rid
tonight=təˈnaɪt
phi=faɪ
constitutional=ˌkɑn(t)stəˈt(j)uʃ(ə)nəl
rapidly=ˈræpədli
italian=ᵻˈtæljən
dow=daʊ
quad=kwɑd
wily=ˈwaɪli
girl=ɡərl
summer=ˈsəmər
presence=ˈprɛzn(t)s
conscious=ˈkɑnʃəs
philosophy=fəˈlɑsəfi
fit=fɪt
indian=ˈɪndiən
reflection=rəˈflɛkʃən
delhi=ˈdɛli
forestry=ˈfɔrəstri
connector=kəˈnɛktər
indoor=ˌɪnˈdɔr
diagram=ˈdaɪəˌɡræm
elect=əˈlɛk(t)
bulk=bəlk
laika=ˈlʌɪkə
manager=ˈmænɪdʒər
spoken=ˈspoʊkən
excess=ɛkˈsɛs
press=prɛs
dock=dɑk
saudi=ˈsaʊdi
tent=tɛnt
referral=rəˈfərəl
lennon=ˈlɛnən
automobile=ˈɔdəmoʊˌbil
diploma=dəˈploʊmə
crop=krɑp
jenny=ˈdʒɛni
remind=rəˈmaɪnd
offset=ˌɔfˈsɛt
shannon=ˈʃænən
restore=rəˈstɔr
please=pliz
every=ˈɛv(ə)ri
boob=bub
busy=ˈbɪzi
marijuana=ˌmɛrəˈ(h)wɑnə
pussy=ˈpʊsi
original=əˈrɪdʒən(ə)l
poverty=ˈpɑvərdi
packaging=ˈpækədʒɪŋ
mos=mɔs
activation=ˌæktəˈveɪʃən
friday=ˈfraɪˌdeɪ
cum=kəm
milk=mɪlk
clarity=ˈklɛrədi
according=əˈkɔrdɪŋ
slovakian=ˌsloʊˈvɑkiən
confuse=kənˈfjuz
tackle=ˈtæk(ə)l
individually=ˌɪndəˈvɪdʒ(ə)wəli
complimentary=ˌkɑmpləˈmɛn(t)əri
finally=ˈfaɪn(ə)li
patio=ˈpædioʊ
columbiad=kəˈlʌmbɪad
poison=ˈpɔɪzn
dakota=dəˈkoʊdə
disability=ˌdɪsəˈbɪlᵻdi
simulation=ˌsɪmjəˈleɪʃən
exterior=ɪkˈstɪriər
perfect=ˈpərfək(t)
intensive=ᵻnˈtɛn(t)sɪv
lately=ˈleɪtli
plot=plɑt
habitat=ˈhæbəˌtæt
transportation=ˌtræn(t)spərˈteɪʃən
egyptian=əˈdʒɪpʃən
hit=hɪt
widely=ˈwaɪdli
keelson=ˈkils(ə)n
postposit=ˌpoʊs(t)ˈpɑzət
stream=strim
took=tʊk
reservoir=ˈrɛzə(r)ˌvwɑr
washington=ˈwɔʃɪŋtən
sodium=ˈsoʊdiəm
destination=ˌdɛstəˈneɪʃən
graph=ɡræf
queen=kwin
gale=ɡeɪl
kuwaiti=kəˈweɪdi
paste=peɪst
barbie=ˈbɑrbi
blend=blɛnd
allen=ˈælən
refurbish=riˈfərbɪʃ
rare=rɛ(ə)r
shuttle=ˈʃəd(ə)l
turkish=ˈtərkɪʃ
since=sɪns
strategy=ˈstrædədʒi
variety=vəˈraɪədi
significantly=sᵻɡˈnɪfᵻkən(t)li
med=mɛd
technological=ˌtɛknəˈlɑdʒək(ə)l
job=dʒɑb
spirit=ˈspɪrᵻt
footage=ˈfʊdɪdʒ
provincial=prəˈvɪn(t)ʃ(ə)l
atomic=əˈtɑmɪk
unfortunately=ˌənˈfɔrtʃ(ə)nətli
argument=ˈɑrɡjəmənt
summit=ˈsəmət
fishing=ˈfɪʃɪŋ
vol=vɑl
vote=voʊt
worldwide=ˈwər(ə)ldˌwaɪd
rock=rɑk
pour=pɔr
premier=priˈmɪ(ə)r
ocean=ˈoʊʃən
stack=stæk
velvet=ˈvɛlvət
commercial=kəˈmərʃəl
armeniac=ɑrˈminiˌæk
nursery=ˈnərs(ə)ri
per=pər
convert=kənˈvərt
environment=ənˈvaɪrə(n)m(ə)nt
parliament=ˈpɑrləm(ə)nt
mall=mɔl
islam=ɪˈslɑm
shed=ʃɛd
disclosure=dᵻˈskloʊʒər
pizza=ˈpitsə
concentration=ˌkɑn(t)sənˈtreɪʃən
tremendous=trəˈmɛndəs
explanation=ˌɛkspləˈneɪʃən
conclude=kənˈklud
de-luxe=dᵻ ˈlʌks
classical=ˈklæsək(ə)l
oman=oʊˈmɑn
carnival=ˈkɑrnəv(ə)l
dress=drɛs
hormone=ˈhɔrˌmoʊn
break=breɪk
lamington=ˈlæmɪŋtən
secretary=ˈsɛkrəˌtɛri
beatle=ˈbiːt(ə)l
requirement=rəˈkwaɪ(ə)rm(ə)nt
sink=sɪŋk
authentic=əˈθɛn(t)ɪk
upload=ˌəpˈloʊd
alternative=ɔlˈtərnədɪv
graduation=ˌɡrædʒʊˈeɪʃən
ultimately=ˈəltəmətli
athlete=ˈæθ(ə)ˌlit
diesel=ˈdiz(ə)l
consortium=kənˈsɔrdiəm
spank=spæŋk
membership=ˈmɛmbərˌʃɪp
montana=mɑnˈtɑnjə
lottery=ˈlɑdəri
dip=dɪp
dartford=ˈdɑrtfərd
executive=ɪɡˈzɛkjədɪv
introduce=ˌɪntrəˈd(j)us
example=ɪɡˈzæmpəl
tribal=ˈtraɪb(ə)l
huge=(h)judʒ
mask=mæsk
rehabilitation=ˌri(h)əˌbɪliˈteɪʃən
theory=ˈθiəri
unless=ənˈlɛs
vacuum=ˈvækˌjum
astronomy=əˈstrɑnəmi
massive=ˈmæsɪv
nasdaq=ˈnæzˌdæk
will=wɪl
eraser=ɪˈreɪsə
being=ˈbiɪŋ
sense=sɛn(t)s
asbestos=æsˈbɛstəs
word=wərd
personality=ˌpərsnˈælədi
plug-in=ˈpləɡˌɪn
religious=rəˈlɪdʒəs
dimensional=dəˈmɛn(t)ʃ(ə)nəl
harry=ˈhɛri
quilt=kwɪlt
article=ˈɑrdək(ə)l
charlie=ˈtʃɑrli
moscow=ˈmɑsˌkaʊ
forgat=fərˈɡæt
aluminium=ˌæləˈmɪniəm
fiorite=fɪˈɔːrʌɪt
governance=ˈɡəvərnən(t)s
beautifully=ˈbjudəfəli
increasingly=ᵻnˈkrisɪŋli
muslim=ˈməzl(ə)m
farm=fɑrm
impair=ɪmˈpɛ(ə)r
catch=kɛtʃ
width=wɪdθ
mazda=ˈmɑzdə
mise=miz
unlikely=ˌənˈlaɪkli
registrar=ˈrɛdʒəˌstrɑr
bankruptcy=ˈbæŋkrəp(t)si
volto=ˈvoʊltoʊ
consent=kənˈsɛnt
enclose=ɛnˈkloʊz
province=ˈprɑv(ə)n(t)s
employer=ᵻmˈplɔɪ(j)ər
polaris=pəˈlɛrəs
angry=ˈæŋɡri
deserve=dəˈzərv
nest=nɛst
ultra=ˈəltrə
milton=ˈmɪlt(ə)n
surgeon=ˈsərdʒən
fair=fɛ(ə)r
critic=ˈkrɪdɪk
idalia=ᵻˈdeɪljə
july=dʒəˈlaɪ
pursue=pərˈs(j)u
super=ˈsupər
raid=reɪd
phantom=ˈfæn(t)əm
decorative=ˈdɛk(ə)rədɪv
training=ˈtreɪnɪŋ
westminster=ˈwɛs(t)ˌmɪn(t)stər
fully=ˈfʊli
denmark=ˈdɛnˌmɑrk
glow=ɡloʊ
librarian=laɪˈbrɛriən
correspond=ˌkɔrəˈspɑnd
leed=lid
oot=uːt
class=klæs
fundamental=ˌfəndəˈmɛn(t)l
dependent=dəˈpɛnd(ə)nt
algebra=ˈældʒəbrə
picture=ˈpɪk(t)ʃər
take=teɪk
cater=ˈkeɪdər
conservative=kənˈsərvədɪv
piece=pis
brochure=broʊˈʃʊ(ə)r
grease=ɡris
backward=ˈbækwərd
nylon=ˈnaɪˌlɑn
yard=jɑrd
erw=ˈɛru
donor=ˈdoʊnər
armour=ˈɑrmər
negotiation=nəˌɡoʊʃiˈeɪʃən
hub=həb
reminder=rəˈmaɪndər
apple=ˈæp(ə)l
ash=æʃ
budget=ˈbədʒət
computation=ˌkɑmpjəˈteɪʃən
sustainability=səˌsteɪnəˈbɪlᵻdi
known=noʊn
listen=ˈlɪsn
infinite=ˈɪnfənət
staffing=ˈstæfɪŋ
directly=dəˈrɛk(t)li
hold-em=ˈhoʊld əm
specially=ˈspɛʃ(ə)li
rooves=ruvs
demonstration=ˌdɛmənˈstreɪʃən
similar=ˈsɪm(ə)lər
may=meɪ
surplus=ˈsərpləs
strictly=ˈstrɪk(t)li
perception=pərˈsɛpʃən
prohibit=prəˈhɪbᵻt
discount=ˈdɪsˌkaʊnt
daughter=ˈdɔdər
confidential=ˌkɑnfəˈdɛn(t)ʃ(ə)l
put=pʊt
ally=əˈlaɪ
apollo=əˈpɑloʊ
collaboration=kəˌlæbəˈreɪʃən
mind=maɪnd
grammar=ˈɡræmər
pleasure=ˈplɛʒər
wan=wɑn
fear=fɪ(ə)r
madison=ˈmædəsən
performance=pərˈfɔrmən(t)s
alliance=əˈlaɪən(t)s
cope=koʊp
aeon=ˈiən
mystery=ˈmɪst(ə)ri
slide=slaɪd
task=tæsk
crucial=ˈkruʃ(ə)l
productivity=ˌprɑdəkˈtɪvᵻdi
acrobat=ˈækrəˌbæt
pack=pæk
continent=ˈkɑnt(ə)nənt
trout=traʊt
bumper=ˈbəmpər
driver=ˈdraɪvər
de-orbit=ˌdiˈɔrbət
nano=ˈnænoʊ
wouldn't=ˈwʊdnt
brooklet=ˈbrʊklɪt
punch=pən(t)ʃ
face=feɪs
boul=bul
anchor=ˈæŋkər
instrument=ˈɪn(t)strəmənt
romance=roʊˈmæn(t)s
mustang=ˈməˌstæŋ
throughout=θruˈaʊt
maryland=ˈmɛrələn(d)
queue=kju
intimate=ˈɪn(t)əmət
max=mæks
california=ˌkæləˈfɔrnjə
detect=dəˈtɛk(t)
oklahoma=ˌoʊkləˈhoʊmə
avatar=ˈævəˌtɑr
shame=ʃeɪm
deboard=ˌdiˈbɔrd
five=faɪv
whether=ˈ(h)wɛðər
cottage=ˈkɑdɪdʒ
any-more=ˌɛni ˈmɔr
traffic=ˈtræfɪk
damn=dæm
about=əˈbaʊt
front-page=ˌfrənt ˈpeɪdʒ
easter=ˈistər
investor=ᵻnˈvɛstər
appear=əˈpɪ(ə)r
satisfactory=ˌsædəsˈfæktəri
during=ˈd(j)ʊrɪŋ
trainer=ˈtreɪnər
weird=wɪ(ə)rd
grip=ɡrɪp
chubby=ˈtʃəbi
court=kɔrt
english=ˈɪŋ(ɡ)lɪʃ
occupy=ˈɑkjəˌpaɪ
plymouth=ˈplɪməθ
how=haʊ
franchise=ˈfrænˌ(t)ʃaɪz
extraction=ɪkˈstrækʃən
lepal=ˈlip(ə)l
bramley=ˈbræmli
badly=ˈbædli
arguer=ˈɑrɡjəwər
crude=krud
probe=proʊb
mackintosh=ˈmækənˌtɑʃ
era=ˈɛrə
spend=spɛnd
administrative=ədˈmɪnəˌstreɪdɪv
leather=ˈlɛðər
dan=dæn
pointer=ˈpɔɪn(t)ər
intel=ˈɪnˌtɛl
thriller=ˈθrɪlər
domestic=dəˈmɛstɪk
tony=ˈtoʊni
authorize=ˈɔθəˌraɪz
helena=ˈhɛlɪnə
appreciate=əˈpriʃiˌeɪt
calvary=ˈkalvəri
rainbow=ˈreɪnˌboʊ
complement=ˈkɑmpləˌmɛnt
excellence=ˈɛksələn(t)s
half-hunter=ˌhæf ˈhən(t)ər
smith=smɪθ
sub=səb
briefly=ˈbrifli
grass=ɡræs
england=ˈɪŋ(ɡ)lənd
celebrity=səˈlɛbrədi
synopsis=səˈnɑpsəs
geek=ɡik
duan=ˈduːən
difficulty=ˈdɪfəkəlti
nation=ˈneɪʃən
canadian=kəˈneɪdiən
postal=ˈpoʊst(ə)l
worked=wərkt
radar=ˈreɪˌdɑr
unemployment=ˌənᵻmˈplɔɪmənt
palestinian=ˌpæləˈstɪniən
toilet=ˈtɔɪlᵻt
market=ˈmɑrkət
procurement=prəˈkjurm(ə)nt
find=faɪnd
shower=ˈʃaʊ(ə)r
clan=klæn
initial=ᵻˈnɪʃ(ə)l
saver=ˈseɪvər
him=hɪm
penalty=ˈpɛnlti
var=vɑr
norfolk=ˈnɔrfək
buddy=ˈbədi
award=əˈwɔrd
psychological=ˌsaɪkəˈlɑdʒək(ə)l
pale=peɪl
chana=ˈtʃənə
induce=ᵻnˈd(j)us
source=sɔrs
birthday=ˈbərθˌdeɪ
ahead=əˈhɛd
ist=ɪst
pipeline=ˈpaɪpˌlaɪn
personally=ˈpərs(ə)nəli
valuation=ˌvæljuˈeɪʃən
molecular=məˈlɛkjələr
hike=haɪk
operational=ˌɑpəˈreɪʃən(ə)l
explore=ᵻkˈsplɔr
classified=ˈklæsəˌfaɪd
lolita=loʊˈlidə
battery=ˈbædəri
swedish=ˈswidɪʃ
provider=prəˈvaɪdər
rugby=ˈrəɡbi
chapter=ˈtʃæptər
computer=kəmˈpjudər
louisianian=luːˌiːzɪˈanɪən
geographical=ˌdʒiəˈɡræfək(ə)l
dollar=ˈdɑlər
entirely=ənˈtaɪ(ə)rli
tactics=ˈtæktɪks
self=sɛlf
bet=bɛt
identification=aɪˌdɛn(t)əfəˈkeɪʃən
consonants=ðə
encourage=ᵻnˈkərɪdʒ
agree=əˈɡri
department=dəˈpɑrtmənt
manner=ˈmænər
testimony=ˈtɛstəˌmoʊni
reply=rəˈplaɪ
manhattan=mænˈhætn
lamp=læmp
again=əˈɡɛn
gadget=ˈɡædʒət
wagon=ˈwæɡən
andic=ˈændɪk
inside=ᵻnˈsaɪd
mood=mud
directive=dəˈrɛktɪv
corn=kɔrn
wrestle=ˈrɛs(ə)l
escort=ᵻˈskɔrt
bold=boʊld
wednesday=ˈwɛnzˌdeɪ
room=rum
watt=wɑt
rod=rɑd
soup=sup
boss=bɔs
experimental=ɪkˌspɛrəˈmɛn(t)l
iran=ɪˈræn
mouse=maʊs
medico=ˈmɛdəˌkoʊ
scott=skɑt
improve=ᵻmˈpruv
programmer=ˈproʊˌɡræmər
necessary=ˈnɛsəˌsɛri
compensation=ˌkɑmpənˈseɪʃən
insulation=ˌɪn(t)səˈleɪʃən
mid=mɪd
financial=fᵻˈnæn(t)ʃ(ə)l
minority=məˈnɔrədi
lycee=lisɛ
institutional=ˌɪn(t)stəˈt(j)uʃ(ə)nəl
independently=ˌɪndəˈpɛndəntli
upcoming=ˈəpˌkəmɪŋ
min=mɪn
jimmy=ˈdʒɪmi
intake=ˈɪnˌteɪk
teen=tin
question=ˈkwɛstʃ(ə)n
message=ˈmɛsɪdʒ
relation=rəˈleɪʃən
elder=ˈɛldər
text=tɛkst
sixth=sɪksθ
sans=sænz
moral=ˈmɔr(ə)l
wiki=ˈwɪki
stanley=ˈstænli
appointment=əˈpɔɪntmənt
literacy=ˈlɪdərəsi
theoretical=ˌθiəˈrɛdək(ə)l
elite=ᵻˈlit
drama=ˈdrɑmə
affordable=əˈfɔrdəb(ə)l
columbus=kəˈləmbəs
master-card=ˈmæstər ˌkɑrd
sando=ˈsændoʊ
surveillance=sərˈveɪlən(t)s
compatible=kəmˈpædəb(ə)l
dining=ˈdaɪnɪŋ
retail=ˈriˌteɪl
wage=weɪdʒ
acrylic=əˈkrɪlɪk
millennium=məˈlɛniəm
existence=ɪɡˈzɪst(ə)n(t)s
metro=ˈmɛtroʊ
shelter=ˈʃɛltər
sauce=sɔs
roger=ˈrɑdʒər
laurence=ˈlɔrən(t)s
plan=plæn
poker=ˈpoʊkər
gravity=ˈɡrævədi
pizze=ˈpitseɪ
charlotte=ˈʃɑrlət
mesh=mɛʃ
watershed=ˈwɔdərˌʃɛd
row=roʊ
pop=pɑp
hospitality=ˌhɑspəˈtælədi
dublin=ˈdəblən
aqua=ˈɑkwə
opt=ɑpt
bus=bəs
vector=ˈvɛktər
corton=ˈkɔːtɒ̃
stakeholder=ˈsteɪkˌ(h)oʊldər
oven=ˈəv(ə)n
standard=ˈstændərd
charity=ˈtʃɛrədi
characterize=ˈkɛr(ə)ktəˌraɪz
continental=ˌkɑn(t)əˈnɛn(t)əl
meta=ˈmɛdə
st-nicholas=ˌseɪn(t) ˈnɪk(ə)ləs
lathy=ˈlæθi
subtle=ˈsədəl
brand=brænd
sustain=səˈsteɪn
maker=ˈmeɪkər
impressive=əmˈprɛsɪv
arizonan=ˌɛrəˈzoʊnən
tue=t(j)u
apt=æpt
ejaculation=əˌdʒækjəˈleɪʃən
abraham=ˈeɪbrəˌhæm
besport=bɪˈspɔːt
ent=ɛnt
spot=spɑt
conservation=ˌkɑn(t)sərˈveɪʃən
naturally=ˈnætʃ(ə)rəli
sector=ˈsɛktər
thai=taɪ
fundraising=ˈfən(d)ˌreɪzɪŋ
laura=ˈlɔrə
consensus=kənˈsɛn(t)səs
senior=ˈsinjər
draught=dræft
university=ˌjunəˈvərsədi
moss=mɔs
george=dʒɔrdʒ
buzz=bəz
preserve=prəˈzərv
literature=ˈlɪdər(ə)tʃər
coral=ˈkɔrəl
sarah=ˈsɛrə
mayest=ˈmeɪᵻst
peaceful=ˈpisf(ə)l
aerospace=ˈɛroʊˌspeɪs
roof=ruf
week=wik
pirate=ˈpaɪrət
integral=ˈɪn(t)əɡrəl
col=kɑl
ethnic=ˈɛθnɪk
spark=spɑrk
amid=əˈmɪd
wicked=ˈwɪkᵻd
bowl=boʊl
archive=ˈɑrˌkaɪv
lend=lɛnd
saving=ˈseɪvɪŋ
christie=ˈkrɪsti
tomato=təˈmeɪdoʊ
blow-job=ˈbloʊ ˌdʒɑb
shopper=ˈʃɑpər
hungary=ˈhʌŋɡəri
amend=əˈmɛnd
scotia=ˈskoʊʃə
worry=ˈwəri
sync=sɪŋk
scanner=ˈskænər
china=ˈtʃaɪnə
lunch=lən(t)ʃ
survive=sərˈvaɪv
declare=dəˈklɛ(ə)r
justice=ˈdʒəstəs
dude=dud
bake=beɪk
optimum=ˈɑptəməm
taipan=ˈtaɪˌpæn
who=hu
huh=hə
universe=ˈjunəvərs
mutual=ˈmjutʃ(əw)əl
luke=luk
insert=ᵻnˈsərt
ago=əˈɡoʊ
brutal=ˈbrudl
mustn't=ˈməsnt
cat=kæt
spokesman=ˈspoʊksmən
shine=ʃaɪn
considerable=kənˈsɪdərəb(ə)l
predict=priˈdɪk(t)
researcher=rəˈsərtʃər
cartoon=kɑrˈtun
balanus=ˈbalənəs
foul=faʊl
justify=ˈdʒəstəˌfaɪ
blake=bleɪk
capable=ˈkeɪpəb(ə)l
avoid=əˈvɔɪd
four=fɔr
over=ˈoʊvər
samba=ˈsæmbə
perhaps=pərˈ(h)æps
mean=min
google=ˈɡuɡ(ə)l
bulletin=ˈbʊlətn
convergence=kənˈvərdʒ(ə)n(t)s
mer=mər
legislative=ˈlɛdʒəˌsleɪdɪv
gratis=ˈɡreɪtɪs
emerald=ˈɛm(ə)rəld
educator=ˈɛdʒəˌkeɪdər
theta=ˈθeɪdə
begin=bəˈɡɪn
championship=ˈtʃæmpiənˌʃɪp
possibly=ˈpɑsəbli
translate=trænzˈleɪt
canst=kæn(t)st
bao=baʊ
calculation=ˌkælkjəˈleɪʃən
subject=ˈsəbdʒək(t)
bingo=ˈbɪŋɡoʊ
nasty=ˈnæsti
constant=ˈkɑn(t)st(ə)nt
blackjack=ˈblækˌdʒæk
full=fʊl
venezuelan=ˌvɛnəz(ə)ˈweɪlən
infringement=ᵻnˈfrɪndʒmənt
part=pɑrt
winter=ˈwɪn(t)ər
yen=jɛn
allan=ˈælən
annual=ˈænj(əw)əl
princess=ˈprɪn(t)sᵻs
ottawa=ˈɑdəˌwɑ
placement=ˈpleɪsm(ə)nt
slot=slɑt
invisible=ᵻnˈvɪzəb(ə)l
terror=ˈtɛrər
browser=ˈbraʊzər
royal=ˈrɔɪ(ə)l
worthy=ˈwərði
transparency=træn(t)ˈspɛrən(t)si
spin=spɪn
limitation=ˌlɪməˈteɪʃən
comfort=ˈkəmfərt
victim=ˈvɪktᵻm
needle=ˈnid(ə)l
doesn't=ˈdəznt
wheat=(h)wit
clinic=ˈklɪnɪk
implementation=ˌɪmpləmənˈteɪʃən
consistently=kənˈsɪstən(t)li
acer=ˈeɪsər
annoy=əˈnɔɪ
mayst=meɪst
serial=ˈsɪriəl
session=ˈsɛʃən
three=θri
property=ˈprɑpərdi
observer=əbˈzərvər
science=ˈsaɪən(t)s
audit=ˈɔdət
biological=ˌbaɪəˈlɑdʒək(ə)l
ave=ˈɑˌveɪ
irrigation=ˌɪrəˈɡeɪʃən
bin=bɪn
rebate=ˈriˌbeɪt
shaw=ʃɔ
crack=kræk
sugar=ˈʃʊɡər
publisher=ˈpəblᵻʃər
cradle=ˈkreɪd(ə)l
houses=ˈhaʊzəz
sale=seɪl
ranking=ˈræŋkɪŋ
disabled=dəˈseɪbəld
lotus=ˈloʊdəs
scsi=ˈskəzi
hook=hʊk
amaze=əˈmeɪz
too=tu
asyla=əˈsaɪlə
precious=ˈprɛʃəs
punishment=ˈpənɪʃm(ə)nt
celtic=ˈkɛltɪk
hose=hoʊz
flame=fleɪm
crew=kru
computational=ˌkɑmpjəˈteɪʃ(ə)nəl
replica=ˈrɛpləkə
cup=kəp
army=ˈɑrmi
audi=əʊdi
chan=tʃæn
retire=rəˈtaɪ(ə)r
blah=blɑ
atlantal=atˈlantəl
wanna=ˈwɔnə
ebony=ˈɛbəni
click=klɪk
sistren=ˈsɪst(ə)rən
crisis=ˈkraɪsᵻs
capacity=kəˈpæsədi
hon=hən
doubt=daʊt
meal=mil
linux=ˈlɪnəks
silence=ˈsaɪlən(t)s
jewish=ˈdʒuɪʃ
chef=ʃɛf
portugal=ˈpoː(r)tʃʊɡʌl
peer=pɪ(ə)r
destiny=ˈdɛstᵻni
anticipate=ænˈtɪsᵻˌpeɪt
board=bɔrd
formerly=ˈfɔrmərli
written=ˈrɪtn
mandate=ˈmænˌdeɪt
expert=ˈɛkˌspərt
elementary=ˌɛləˈmɛnt(ə)ri
hint=hɪnt
sexy=ˈsɛksi
vermont=vərˈmɑnt
proposition=ˌprɑpəˈzɪʃən
skilled=skɪld
heavy=ˈhɛvi
mint=mɪnt
strip=strɪp
recruitment=rəˈkrutm(ə)nt
found=faʊnd
patrol=pəˈtroʊl
liable=ˈlaɪəb(ə)l
smooth=smuð
motel=moʊˈtɛl
optimize=ˈɑptəˌmaɪz
cloud=klaʊd
gibraltar=dʒɪˈbrɒltə
flicker=ˈflɪkər
thy=ðaɪ
assess=əˈsɛs
nashville=ˈnæʃˌvɪl
on-to=ˈɔnˌtə
sister=ˈsɪstər
serum=ˈsɪrəm
fan=fæn
refine=rəˈfaɪn
orient=ˈɔriənt
quantum=ˈkwɑn(t)əm
really=ˈri(ə)li
choir=ˈkwaɪər
cana=ˈkɑnjə
registry=ˈrɛdʒəstri
titan=ˈtaɪtn
school=skul
baltimore=ˈbɔːltɪmɔː
table=ˈteɪb(ə)l
sender=ˈsɛndər
nor=nɔr
cream=krim
aquatic=əˈkwɑdɪk
basketball=ˈbæskətˌbɔl
obituary=əˈbɪtʃəˌwɛri
light-box=ˈlaɪt ˌbɑks
properly=ˈprɑpərli
drag=dræɡ
leone=liˈoʊn
dutchland=ˈdʌtʃland
advise=ədˈvaɪz
something=ˈsəmˌθɪŋ
lancaster=ˈlæŋˌkæstər
nomination=ˌnɑməˈneɪʃən
these=ðiz
though=ðoʊ
back-up=ˌbækˈəp
spanking=ˈspæŋkɪŋ
baseline=ˈbeɪsˌlaɪn
start=stɑrt
geo=ˈdʒioʊ
maiden=ˈmeɪdən
specialist=ˈspɛʃ(ə)ləst
skate=skeɪt
reputation=ˌrɛpjəˈteɪʃən
ninon=ˈniˌnɑn
meeting=ˈmidɪŋ
endless=ˈɛn(d)ləs
permalink=ˈpərm(ə)lɪŋk
sometimes=ˈsəmˌtaɪmz
mouille=muˈjeɪ
astrology=əˈstrɑlədʒi
cayman=ˈkeɪmən
nude=n(j)ud
printer=ˈprɪn(t)ər
tribunal=traɪˈbjunəl
seafood=ˈsiˌfud
petite=pəˈtit
storm=stɔrm
confusion=kənˈfjuʒ(ə)n
together=təˈɡɛðər
farm-in=ˈfɑrmˌɪn
romanita=roʊˌmænəˈtɑ
brief=brif
mime=maɪm
tide=taɪd
jpeg=ˈdʒeɪˌpɛɡ
last=læst
panela=pəˈnɛlə
digest=dəˈdʒɛst
treasure=ˈtrɛʒər
thus=ðəs
penguin=ˈpɛŋɡw(ə)n
arbitration=ˌɑrbəˈtreɪʃən
recording=rəˈkɔrdɪŋ
christer=ˈkraɪstər
oases=oʊˈeɪˌsiz
difference=ˈdɪf(ə)rən(t)s
equality=iˈkwɑlədi
newspaper=ˈn(j)uzˌpeɪpər
omission=oʊˈmɪʃən
some=səm
successful=səkˈsɛsf(ə)l
governmental=ˌɡəvər(n)ˈmɛn(t)l
reform=rəˈfɔrm
cite=saɪt
dumb=dəm
colonial=kəˈloʊnjəl
jaguar=ˈdʒæɡˌwɑr
levada=lɛˈvɑːdə
kelly=ˈkɛli
cent=sɛnt
file=faɪl
snowboard=ˈsnoʊˌbɔrd
realty=ˈri(ə)lti
recognition=ˌrɛkəɡˈnɪʃən
ever=ˈɛvər
slut=slət
pure=pjʊ(ə)r
intersection=ˌɪn(t)ərˈsɛkʃən
simultaneously=ˌsaɪməlˈteɪniəsli
pray=preɪ
border=ˈbɔrdər
coastal=ˈkoʊst(ə)l
holiday=ˈhɑləˌdeɪ
administer=ədˈmɪnᵻstər
contact=ˈkɑntæk(t)
brush=brəʃ
stem=stɛm
daily=ˈdeɪli
machinery=məˈʃin(ə)ri
shipment=ˈʃɪpmənt
south-east=ˌsaʊθˈist
command=kəˈmænd
reunion=riˈjunjən
exemption=ɪɡˈzɛm(p)ʃən
stria=ˈstraɪə
til=tɪl
bride=braɪd
conversion=kənˈvərʒən
cardia=ˈkɑrdiə
establishment=əˈstæblɪʃmənt
rev=rɛv
compatibility=kəmˌpædəˈbɪlᵻdi
tenant=ˈtɛnənt
serve=sərv
texture=ˈtɛk(st)ʃər
inquire=ᵻnˈkwaɪ(ə)r
bruz=brəz
explorer=ᵻkˈsplɔrər
midnight=ˈmɪdˌnaɪt
tourism=ˈtʊˌrɪzəm
mat=mæt
anyone=ˈɛniˌwən
lid=lɪd
startup=ˈstɑrdˌəp
emirate=ˈɛm(ə)rət
refresh=rəˈfrɛʃ
avidin=ˈavɪdɪn
nickel=ˈnɪk(ə)l
ferranti=fəˈrɑn(t)i
medieval=ˌmid(i)ˈiv(ə)l
moderate=ˈmɑd(ə)rət
headphone=ˈhɛdˌfoʊn
dee=di
nutting=ˈnədɪŋ
side=saɪd
senator=ˈsɛnədər
learn=lərn
yang=jæŋ
distinct=dəˈstɪŋ(k)t
mileage=ˈmaɪlɪdʒ
submission=səbˈmɪʃən
singer=ˈsɪŋər
make=meɪk
prefix=ˈpriˌfɪks
son=sən
passport=ˈpæsˌpɔrt
initially=ᵻˈnɪʃ(ə)li
savannah=səˈvænə
april=ˈeɪprəl
somerset=ˈsəmərˌsɛt
vaccine=vækˈsin
generation=ˌdʒɛnəˈreɪʃən
lincoln=ˈlɪŋkən
skip=skɪp
jill=dʒɪl
aurora=əˈrɔrə
went=wɛnt
pic=pɪk
sussex=ˈsəsəks
future=ˈfjutʃər
inventory=ˈɪnvənˌtɔri
pac=pæk
sherman=ˈʃərmən
button=ˈbətn
bizarre=bəˈzɑr
interpret=ᵻnˈtərprət
nigerian=naɪˈdʒɪriən
bare=bɛ(ə)r
electro=əˈlɛktroʊ
map=mæp
grant=ɡrænt
breath=brɛθ
newton=ˈn(j)utn
species=ˈspiʃiz
envelope=ˈɛnvəˌloʊp
respondent=rəˈspɑnd(ə)nt
unwrap=ˌənˈræp
mud=məd
brussels=ˈbrʌsəlz
disposition=ˌdɪspəˈzɪʃən
minimum=ˈmɪnəməm
exotic=ɪɡˈzɑdɪk
estonian=ɛˈstoʊniən
dirt=dərt
demand=dəˈmænd
scholarship=ˈskɑlərˌʃɪp
bass=beɪs
household=ˈhaʊsˌ(h)oʊld
lea-land=ˈliˌlænd
earring=ˈɪrˌrɪŋ
bibliographic=ˌbɪbliəˈɡræfɪk
superb=suˈpərb
sigma=ˈsɪɡmə
icon=ˈaɪˌkɑn
weak=wik
topless=ˈtɑpləs
besides=bəˈsaɪdz
racial=ˈreɪʃ(ə)l
bean=bin
familiar=fəˈmɪljər
matt=mæt
southern=ˈsəðərn
au=ˌeɪˈju
season=ˈsiz(ə)n
arrow=ˈɛroʊ
eve=iv
thailander=ˈtaɪˌlændər
hungarian=həŋˈɡɛriən
lovely=ˈləvli
berkeley=ˈbɑrkli
ref=rɛf
shot=ʃɑt
advocate=ˈædvəkət
everyone=ˈɛvri(ˌ)wən
adelaide=ˈædlˌeɪd
immediate=ᵻˈmidiət
providence=ˈprɑvəd(ə)n(t)s
town=taʊn
joist=dʒɔɪst
ir=ˌaɪˈɑr
handy=ˈhændi
ray=reɪ
cargo=ˈkɑrɡoʊ
smart=smɑrt
labour=ˈleɪbər
wrote=roʊt
survival=sərˈvaɪv(ə)l
vampire=ˈvæmˌpaɪ(ə)r
laugh=læf
movie=ˈmuvi
periodically=ˌpɪriˈɑdək(ə)li
elderly=ˈɛldərli
union=ˈjunjən
basket=ˈbæskət
arthur=ˈɑrθər
bolivian=bəˈlɪviən
suggestion=səˈdʒɛstʃən
barbara=ˈbɑːbərə
fabulous=ˈfæbjələs
india=ˈɪndiə
repository=rəˈpɑzəˌtɔri
sol=sɔl
artistic=ɑrˈtɪstɪk
kentucky=kənˈtəki
fairly=ˈfɛrli
responsible=rəˈspɑn(t)səb(ə)l
ser=ˌɛsˌiˈɑr
vulnerable=ˈvəlnər(ə)bəl
myth=mɪθ
elevation=ˌɛləˈveɪʃən
heater=ˈhidər
semiconductor=ˈsɛmikənˌdəktər
deave=div
appro=ˈaprəʊ
uganda=juˈɡɑndə
lil=lɪl
housing=ˈhaʊzɪŋ
novelty=ˈnɑvəlti
different=ˈdɪf(ə)rənt
god=ɡɑd
bed=bɛd
holland=ˈhɑlənd
stand=stænd
valuable=ˈvælj(əw)əb(ə)l
girlfriend=ˈɡərlˌfrɛnd
supplier=səˈplaɪ(ə)r
fake=feɪk
shoot=ʃut
ambiens=ˈæmbiˌɛnz
rarely=ˈrɛrli
wallpaper=ˈwɔlˌpeɪpər
interview=ˈɪn(t)ərˌvju
heaven=ˈhɛv(ə)n
jade=dʒeɪd
periodic=ˌpɪriˈɑdɪk
guarantee=ˌɡɛrənˈti
beslime=bəˈslaɪm
nesties=ˈnɛstiz
timber=ˈtɪmbər
eau=oʊ
madagascar=ˌmædəˈɡæskər
carter=ˈkɑrdər
troop=trup
webcam=ˈwɛbˌkæm
claire=klɛː
roland=ˈroʊlən(d)
flower=ˈflaʊər
anything=ˈɛniˌθɪŋ
western=ˈwɛstərn
humidity=(h)juˈmɪdᵻdi
fin=fɪn
hart=hɑrt
adnex=ˈædˌnɛks
correctly=kəˈrɛk(t)li
johnson=ˈdʒɑn(t)s(ə)n
receipt=rəˈsit
navigator=ˈnævəˌɡeɪdər
courage=ˈkərɪdʒ
pension=ˈpɛnʃən
yeah=jɛ(ə)
rubai=ruˈbaɪ
evidence=ˈɛvəd(ə)n(t)s
portuguese=ˈpɔrtʃəˌɡiz
triangle=ˈtraɪˌæŋɡ(ə)l
secret=ˈsikrᵻt
physical=ˈfɪzək(ə)l
deviant=ˈdiviənt
bangkok=baŋkɒk
batman=ˈbatmən
subscriber=səbˈskraɪbər
account=əˈkaʊnt
earthquake=ˈərθˌkweɪk
firebox=ˈfaɪ(ə)rˌbɑks
marvel=ˈmɑrvəl
carl=kɑrl
edger=ˈɛdʒər
legislation=ˌlɛdʒəˈsleɪʃən
strand=strænd
animated=ˈænəˌmeɪdᵻd
discharge=ˈdɪsˌtʃɑrdʒ
silver=ˈsɪlvər
amazon=ˈæməˌzɑn
brook=brʊk
glance=ɡlæn(t)s
humanity=hjuˈmænədi
supporter=səˈpɔrdər
premium=ˈprimiəm
genuine=ˈdʒɛnjəwən
psychiatry=səˈkaɪətri
publicly=ˈpəblᵻkli
relevance=ˈrɛləv(ə)n(t)s
latter=ˈlædər
escape=əˈskeɪp
wash=wɔʃ
friend=frɛnd
christ=kraɪst
jump=dʒəmp
reading=ˈridɪŋ
panel=ˈpæn(ə)l
princeton=ˈprɪn(t)st(ə)n
thomson=ˈtɒmsən
gonna=ˈɡənə
declaration=ˌdɛkləˈreɪʃən
roll=roʊl
windsor=ˈwɪnzər
colorado=ˌkɑləˈrɑdoʊ
fifteen=ˌfɪfˈtin
manor=ˈmænər
winner=ˈwɪnər
complexity=kəmˈplɛksədi
always=ˈɔlwəz
short-cut=ˈʃɔrt ˌkət
bureau=ˈbjʊroʊ
head=hɛd
eclipse=əˈklɪps
brake=breɪk
indicate=ˈɪndəˌkeɪt
salvation=sælˈveɪʃən
burton=ˈbəːt(ə)n
superintendent=ˌsup(ə)rᵻnˈtɛndənt
camaron=kaməˈrəʊn
kawaii=kəˈwaɪ
stat=stæt
greeting=ˈɡridɪŋ
nintendo=nɪnˈtɛndoʊ
civilization=ˌsɪvələˈzeɪʃən
experiment=ɪkˈspɛrəmənt
till=tɪl
magnitude=ˈmæɡnəˌt(j)ud
yeses=ˈjɛsəz
greet=ɡrit
himself=hɪmˈsɛlf
train=treɪn
quickly=ˈkwɪkli
utilization=ˌjudl̩əˈzeɪʃən
junior=ˈdʒunjər
certificate=sərˈtɪfəkət
albertan=ælˈbərtn
Moslem=ˈmɑzləm
brazilian=brəˈzɪljən
levy=ˈlɛvi
power-point=ˈpaʊ(ə)r ˌpɔɪnt
arab=ˈɛrəb
meat=mit
luxembourger=ˈləksəmˌbərɡər
belong=bəˈlɔŋ
style=staɪl
attempt=əˈtɛm(p)t
imperial=ᵻmˈpɪriəl
evident=ˈɛvəd(ə)nt
gabriel=ˈɡeɪbriəl
latices=ˈleɪdəˌsiz
quotation=ˌkwoʊˈteɪʃən
variance=ˈvɛriəns
polish=ˈpɑlɪʃ
buffalo=ˈbəfəˌloʊ
accommodate=əˈkɑməˌdeɪt
sperm=spərm
motivate=ˈmoʊdəˌveɪt
culture=ˈkəltʃər
loper=ˈləʊpə
favour=ˈfeɪvər
impossible=ᵻmˈpɑsəb(ə)l
hurricane=ˈhərəˌkeɪn
domain=doʊˈmeɪn
samiel=ˈsɑːmɪəl
synthesis=ˈsɪnθəsəs
theatre=ˈθiədər
wellington=ˈwɛlɪŋt(ə)n
brazil=ˈbræz(ə)l
alike=əˈlaɪk
billion=ˈbɪljən
stationery=ˈsteɪʃəˌnɛri
maintain=meɪnˈteɪn
seal=si(ə)l
holder=ˈhoʊldər
kai=kaɪ
proposal=prəˈpoʊz(ə)l
service=ˈsərvəs
chip=tʃɪp
hijiki=hᵻˈdʒiki
savage=ˈsævɪdʒ
society=səˈsaɪədi
valium=ˈvæliəm
evil=ˈiv(ə)l
rio=ˈrioʊ
wale=weɪl
vary=ˈvɛri
urgent=ˈərdʒənt
islamic=ɪˈslɑmɪk
shut=ʃət
everybody=ˈɛvri(ˌ)bədi
condo=ˈkɑnˌdoʊ
po=poʊ
bangladeshi=ˌbɑŋɡləˈdɛʃi
barn=bɑrn
enrolment=ᵻnˈroʊlmənt
could=kʊd
taste=teɪst
carb=kɑrb
unlock=ˌənˈlɑk
phiz=fɪz
subsequent=ˈsəbsəkwənt
track=træk
writ=rɪt
cut-shot=ˈkət ˌʃɑt
freelance=ˈfriˌlæn(t)s
trigger=ˈtrɪɡər
criticism=ˈkrɪdəˌsɪzəm
creature=ˈkritʃər
porn=pɔrn
update=ˌəpˈdeɪt
jordan=ˈdʒɔrd(ə)n
order=ˈɔrdər
mod=moʊd
paradise=ˈpɛrəˌdaɪs
brass=bræs
communication=kəˌmjunəˈkeɪʃən
subsection=ˈsəbˌsɛkʃən
sue=su
sen=sɛn
atmosphere=ˈætməˌsfɪ(ə)r
plant=plænt
perform=pərˈfɔrm
pharmaceutical=ˌfɑrməˈsudəkəl
horror=ˈhɔrər
notify=ˈnoʊdəˌfaɪ
gather=ˈɡæðər
priest=prist
tri=traɪ
victory=ˈvɪkt(ə)ri
guideline=ˈɡaɪdˌlaɪn
gang-bang=ˈɡæŋˌbæŋ
likely=ˈlaɪkli
alternate=ˈɔltərnət
polo=ˈpoʊloʊ
log=lɔɡ
story=ˈstɔri
ice=aɪs
soil=sɔɪl
shanghai=ˌʃæŋˈhaɪ
contribution=ˌkɑntrəˈbjuʃən
pan=pæn
endorsement=ᵻnˈdɔrsmənt
illustrate=ˈɪləˌstreɪt
ethernet=ˈiθərˌnɛt
feel=fil
rocket=ˈrɑkət
economic=ˌɛkəˈnɑmɪk
humane=hjuˈmeɪn
snap=snæp
each=itʃ
revenge=rəˈvɛndʒ
choice=tʃɔɪs
consist=kənˈsɪst
customize=ˈkəstəˌmaɪz
fifty=ˈfɪfti
rob=rɑb
babe=beɪb
select=səˈlɛk(t)
guatemalan=ˌɡwɑdəˈmɑlən
joke=dʒoʊk
approve=əˈpruv
worth=wərθ
mayor=ˈmeɪ(ə)r
marry=ˈmɛri
camcorder=ˈkamkɔːdə
norte=ˈnɔrdeɪ
auction=ˈɔkʃən
orgies=ˈɔrdʒiz
inspector=ᵻnˈspɛktər
swinger=ˈswɪŋər
berlin=bərˈlɪn
bra=brɑ
helicopter=ˈhɛləˌkɑptər
cheque=tʃɛk
transparent=træn(t)ˈspɛrənt
singh=sɪŋ
setting=ˈsɛdɪŋ
congo=ˈkɑŋɡoʊ
puppy=ˈpəpi
dawn=dɔn
national=ˈnæʃən(ə)l
addition=əˈdɪʃən
demonstrate=ˈdɛmənˌstreɪt
rape=reɪp
philip=ˈfɪlᵻp
essay=ˈɛseɪ
accuracy=ˈækjərəsi
blad=blæd
treaty=ˈtridi
mug=məɡ
reliance=rəˈlaɪən(t)s
prime=praɪm
peter=ˈpidər
sub-age=ˈsəbˌeɪdʒ
active=ˈæktɪv
aside=əˈsaɪd
defer=dəˈfər
freely=ˈfrili
sure=ʃʊ(ə)r
suitable=ˈsudəb(ə)l
happiness=ˈhæpinᵻs
hibachi=həˈbɑtʃi
learnt=lərnt
genesis=ˈdʒɛnəsəs
footwear=ˈfʊtˌwɛ(ə)r
broker=ˈbroʊkər
isle=aɪl
usdaw=ˈʌzdɔː
concord=ˈkɑŋkərd
create=kriˈeɪt
wilt=wɪlt
ceiling=ˈsilɪŋ
forum=ˈfɔrəm
probably=ˈprɑbəbli
fuck=fək
drawn=drɔn
nudity=ˈn(j)udədi
readily=ˈrɛdəli
deliver=dəˈlɪvər
user=ˈjuzər
confirm=kənˈfərm
chaos=ˈkeɪˌɑs
furthermore=ˈfərðərˌmɔr
execute=ˈɛksəˌkjut
billy=ˈbɪli
milf=mɪlf
applaud=əˈplɔd
rebound=ˈriˌbaʊnd
catalyst=ˈkædləst
warn=wɔrn
grocery=ˈɡroʊs(ə)ri
allocate=ˈæləˌkeɪt
conclusion=kənˈkluʒən
tablet=ˈtæblət
theme=θim
casino=kəˈsinoʊ
scuba=ˈskjuːbə
queensland=ˈkwinzlənd
combat=ˈkɑmˌbæt
steeve=stiv
item=ˈaɪdəm
exempt=ɪɡˈzɛm(p)t
jack-boy=ˈdʒækˌbɔɪ
journey=ˈdʒərni
slim=slɪm
beauty=ˈbjudi
fighter=ˈfaɪdər
likelihood=ˈlaɪkliˌ(h)ʊd
match=mætʃ
selection=səˈlɛkʃən
adaptor=əˈdæptər
grateful=ˈɡreɪtf(ə)l
cherry=ˈtʃɛri
petroleum=pəˈtroʊliəm
depend=dəˈpɛnd
progress=ˈprɑɡrəs
protest=ˈproʊˌtɛst
semi=ˈsɛˌmaɪ
per-cent=pər ˈsɛnt
assure=əˈʃʊ(ə)r
trustee=ˌtrəˈsti
dietary=ˈdaɪəˌtɛri
noria=ˈnɔriə
swim=swɪm
juice=dʒus
possibility=ˌpɑsəˈbɪlᵻdi
equal=ˈikw(ə)l
mining=ˈmaɪnɪŋ
doc=dɑk
router=ˈraʊdər
frequently=ˈfrikwən(t)li
controller=kənˈtroʊlər
necessarily=ˌnɛsəˈsɛrəli
frank=fræŋk
advertisement=ˈædvərˌtaɪzmənt
protection=prəˈtɛkʃən
penes=ˈpiˌniz
oba=ˈɔbə
introductory=ˌɪntrəˈdəkt(ə)ri
worship=ˈwərʃəp
subsequently=ˈsəbsəkwəntli
mary=ˈmɛri
advancement=ədˈvæn(t)sm(ə)nt
ship=ʃɪp
november=noʊˈvɛmbər
option=ˈɑpʃən
arcade=ɑrˈkeɪd
exec=ɛɡˈzɛk
shoe=ʃu
mini=ˈmɪni
twice=twaɪs
flag=flæɡ
ours=ˈaʊ(ə)rz
tender=ˈtɛndər
barbados=bɑːˈbeɪdɒs
biography=baɪˈɑɡrəfi
know=noʊ
rwanda=rʊˈɑndə
tech=tɛk
yesterday=ˈjɛstərˌdeɪ
rough=rəf
initiate=ᵻˈnɪʃiˌeɪt
anime=ˌænəˈmeɪ
throat=θroʊt
cable=ˈkeɪb(ə)l
painting=ˈpeɪn(t)ɪŋ
reality=riˈælədi
restaurant=ˈrɛst(ə)rənt
private=ˈpraɪvᵻt
proxy=ˈprɑksi
cloudy=ˈklaʊdi
est=ɛst
advertiser=ˈædvərˌtaɪzər
cloth=klɔθ
poly=ˈpoʊli
series=ˈsɪriz
carefully=ˈkɛrf(ə)li
mason=ˈmeɪsn
newcastle=ˈn(j)uˌkæs(ə)l
ugly=ˈəɡli
proportion=prəˈpɔrʃən
sig=sɪɡ
safety=ˈseɪfti
dale=deɪl
code=koʊd
curious=ˈkjʊriəs
transcript=ˈtrænzˌkrɪpt
candle=ˈkænd(ə)l
julia=ˈdʒuljə
integrate=ˈɪn(t)əˌɡreɪt
jake=dʒeɪk
farming=ˈfɑrmɪŋ
invite=ᵻnˈvaɪt
barrel=ˈbɛrəl
gorgeous=ˈɡɔrdʒəs
outsource=ˈaʊtˌsɔrs
transcription=træn(t)ˈskrɪpʃən
love=ləv
debut=deɪˈbju
anna=ˈænə
paper=ˈpeɪpər
scope=skoʊp
chat=tʃæt
sip=sɪp
sad=sæd
solar=ˈsoʊlər
million=ˈmɪljən
n'=(ə)n
excite=ɪkˈsaɪt
agba=ˈæɡbə
commander=kəˈmændər
auburn=ˈɔːbəːn
alien=ˈeɪljən
simpson=ˈsɪm(p)s(ə)n
stereo=ˈstɛriːəʊ
club=kləb
buff=bəf
get=ɡɛt
virginia=vərˈdʒɪnjə
chevron=ˈʃɛvrən
prince=prɪn(t)s
jacky=ˈdʒæki
sox=sɑks
warning=ˈwɔrnɪŋ
venture=ˈvɛn(t)ʃər
knock=nɑk
integer=ˈɪn(t)ədʒər
cab=kæb
shark=ʃɑrk
reliability=rəˌlaɪəˈbɪlᵻdi
outdoor=ˌaʊtˈdɔr
randy=ˈrændi
steady=ˈstɛdi
medicare=ˈmɛdəˌkɛ(ə)r
significant=sᵻɡˈnɪfᵻk(ə)nt
be-er=ˈbiər
removal=rəˈmuv(ə)l
combo=ˈkɑmboʊ
entitle=ᵻnˈtaɪd(ə)l
comprehensive=ˌkɑmprəˈhɛn(t)sɪv
handheld=ˈhæn(d)ˌhɛld
semantic=səˈmæn(t)ɪk
utilize=ˈjudlˌaɪz
james=dʒeɪmz
defend=dəˈfɛnd
recreation=ˌrɛkriˈeɪʃən
tradition=trəˈdɪʃən
asian=ˈeɪʒən
ozone=ˈoʊˌzoʊn
zoo=zu
logical=ˈlɑdʒək(ə)l
consistency=kənˈsɪstn(t)si
consistent=kənˈsɪst(ə)nt
look=lʊk
judy=ˈdʒudi
illustration=ˌɪləˈstreɪʃən
in-box=ˈɪnˌbɑks
big=bɪɡ
blogger=ˈblɑɡər
someone=ˈsəmˌwən
cool=kul
visibility=ˌvɪzəˈbɪlᵻdi
wait=weɪt
salary=ˈsæləri
coupon=ˈk(j)uˌpɑn
shelf=ʃɛlf
dice=daɪs
calkin=ˈkɔkən
flip=flɪp
pittsburgher=ˈpɪtsˌbərɡər
rose=roʊz
london=ˈləndən
journal=ˈdʒərn(ə)l
dairy=ˈdɛri
jamaica=dʒəˈmeɪkə
arrangement=əˈreɪndʒmənt
blare=blɛ(ə)r
pickup=ˈpɪkˌəp
office=ˈɔfəs
station=ˈsteɪʃən
nova=ˈnoʊvə
plastic=ˈplæstɪk
fork=fɔrk
allocation=ˌæləˈkeɪʃən
negative=ˈnɛɡədɪv
yeast=jist
comply=kəmˈplaɪ
tone=toʊn
borough=ˈbəroʊ
can=kæn
speaker=ˈspikər
master=ˈmæstər
spectacular=spɛkˈtækjələr
woman=ˈwʊmən
transaction=trænˈzækʃən
debug=ˌdiˈbəɡ
dinner=ˈdɪnər
contrary=ˈkɑntrɛri
building=ˈbɪldɪŋ
blow=bloʊ
chubb=tʃəb
bacterium=bækˈtɪriəm
nottingham=ˈnɑdɪŋˌhæm
occasionally=əˈkeɪʒ(ə)nəli
conduct=kənˈdək(t)
humour=ˈ(h)jumər
reservation=ˌrɛzərˈveɪʃən
caitiff=ˈkeɪdəf
rain=reɪn
spec=spɛk
basin=ˈbeɪsn
nasa=ˈnæsə
tunisian=tjuːˈnɪzɪən
spring=sprɪŋ
agriculture=ˈæɡrəˌkəltʃər
keen=kin
assembly=əˈsɛmbli
game=ɡeɪm
locator=ˈloʊˌkeɪdər
popularity=ˌpɑpjəˈlɛrədi
marsh=mɑrʃ
polyphonic=ˌpɑliˈfɑnɪk
clerk=klərk
fuel=ˈfju(ə)l
dick=dɪk
ftp=ˌɛftiˈpi
later=ˈleɪdər
bahaman=bəˈhɑmən
abandon=əˈbændən
survivor=sərˈvaɪvər
tiffany=ˈtɪfəni
notion=ˈnoʊʃən
significance=sᵻɡˈnɪfᵻk(ə)n(t)s
lucca=ˈluːkə
addiction=əˈdɪkʃən
greatly=ˈɡreɪtli
criterion=kraɪˈtɪriən
réfugié=ˌreɪfuʒiˈeɪ
announcement=əˈnaʊn(t)smənt
initiative=ᵻˈnɪʃədɪv
awareness=əˈwɛrnəs
production=prəˈdəkʃən
tournament=ˈtərnəmənt
anniversary=ˌænəˈvərs(ə)ri
laboratory=ˈlæbrəˌtɔri
surrey=ˈsəri
video=ˈvɪdioʊ
sophisticated=səˈfɪstəˌkeɪdəd
trio=ˈtrioʊ
educate=ˈɛdʒəˌkeɪt
pike=paɪk
atlantic=ətˈlæn(t)ɪk
stood=stʊd
convention=kənˈvɛn(t)ʃən
mariotte=ˈmɛriˌɑt
sport=spɔrt
twink=twɪŋk
box=bɑks
michigan=ˈmɪʃᵻɡ(ə)n
electronic=əˌlɛkˈtrɑnɪk
effort=ˈɛfərt
warren=ˈwɔrən
moreover=mɔˈroʊvər
hostel=ˈhɑst(ə)l
jeep=dʒip
challenge=ˈtʃæləndʒ
incident=ˈɪn(t)sədnt
potato=pəˈteɪdoʊ
adjustable=əˈdʒəstəb(ə)l
tribune=ˈtrɪbjun
vegetarian=ˌvɛdʒəˈtɛriən
measure=ˈmɛʒər
inappropriate=ˌɪnəˈproʊpriət
programme=ˈproʊˌɡræm
rely=rəˈlaɪ
safely=ˈseɪfli
collectable=kəˈlɛktəb(ə)l
mare=ˈmɑreɪ
require=rəˈkwaɪ(ə)r
vienna=ˌviˈɛnə
scottish=ˈskɑdɪʃ
save=seɪv
broadcast=ˈbrɔdˌkæst
jungle=ˈdʒʌŋɡ(ə)l
montreal=ˌmɑntriˈɔl
soon=sun
spy=spaɪ
witch=wɪtʃ
store=stɔr
administrator=ədˈmɪnəˌstreɪdər
anthropology=ˌænθrəˈpɑlədʒi
expensive=ɪkˈspɛn(t)sɪv
indie=ˈɪndi
producer=prəˈd(j)usər
dod=dɑd
bite=baɪt
logic=ˈlɑdʒɪk
circus=ˈsərkəs
yourself=jɔrˈsɛlf
treasurer=ˈtrɛʒ(ə)rər
midwest=ˌmɪdˈwɛst
sheet=ʃit
font=fɑnt
enterprise=ˈɛn(t)ərˌpraɪz
legacy=ˈlɛɡəsi
gallery=ˈɡæl(ə)ri
cheap=tʃip
advert=ædˈvərt
mixture=ˈmɪk(st)ʃər
uncertainty=ˌənˈsərtnti
yours=jɔrz
destroy=dəˈstrɔɪ
tariff=ˈtɛrəf
accessibility=əkˌsɛsəˈbɪlᵻdi
explicit=ᵻkˈsplɪsᵻt
dialogue=ˈdaɪəˌlɔɡ
asset=ˈæˌsɛt
unlimited=ˌənˈlɪmᵻdᵻd
syndicate=ˈsɪndəkət
gem=dʒɛm
particle=ˈpɑrdək(ə)l
anonymous=əˈnɑnəməs
principal=ˈprɪn(t)səp(ə)l
mought=maʊt
bitten=ˈbɪtn
king=kɪŋ
veterinary=ˈvɛdərəˌnɛri
enable=ᵻˈneɪb(ə)l
phoenix=ˈfinɪks
bracelet=ˈbreɪslət
papua=ˈpɑpʊə
succeed=səkˈsid
actively=ˈæktᵻvli
thing=θɪŋ
florida=ˈflɔrᵻdə
least=list
templet=ˈtɛmplət
never=ˈnɛvər
gui=ˈɡui
renewable=rəˈn(j)uəb(ə)l
inc=ɪŋk
booth=buθ
biodiversity=ˌbaɪoʊdəˈvərsədi
herbal=ˈ(h)ərb(ə)l
bang=bæŋ
automotive=ˌɔdəˈmoʊdɪv
go-to=ˈɡoʊˌtu
coward=ˈkaʊərd
funny=ˈfəni
acre=ˈeɪkər
ordinary=ˈɔrdnˌɛri
val=væl
college=ˈkɑlɪdʒ
fossil=ˈfɑs(ə)l
format=ˈfɔrˌmæt
parking=ˈpɑrkɪŋ
delete=dəˈlit
elegant=ˈɛləɡənt
decian=ˈdiːʃ(ɪ)ən
emic=ˈiːmɪk
affiliate=əˈfɪliˌeɪt
avenue=ˈævəˌn(j)u
bull=bʊl
necklace=ˈnɛkləs
traverse=trəˈvərs
profile=ˈproʊˌfaɪl
italic=ᵻˈtælɪk
furniture=ˈfərnᵻtʃər
transsexual=træn(t)(s)ˈsɛkʃ(əw)əl
trail=treɪl
nowell=noʊˈ(w)ɛl
resident=ˈrɛz(ə)d(ə)nt
garlic=ˈɡɑrlɪk
guy=ɡaɪ
davis=ˈdeɪvəs
menu=ˈmɛnju
route=rut
ignore=ɪɡˈnɔr
scroll=skroʊl
beaver=ˈbivər
killer=ˈkɪlər
weed=wid
brother=ˈbrəðər
activate=ˈæktəˌveɪt
actual=ˈæk(t)ʃ(əw)əl
default=dəˈfɔlt
honest=ˈɑnəst
census=ˈsɛn(t)səs
song=sɔŋ
zeroes=ˈzɪroʊz
summary=ˈsəməri
extensive=ɪkˈstɛnsɪv
honduras=hɑnˈd(j)ʊrəs
square=skwɛ(ə)r
toolkit=ˈtulˌkɪt
stupid=ˈst(j)upəd
decorate=ˈdɛkəˌreɪt
realtor=ˈri(ə)ltər
substantial=ˌsəbˈstæn(t)ʃəl
warranty=ˈwɔrən(t)i
armstrong=ˈɑrmˌstrɔŋ
cubic=ˈkjubɪk
masturbation=ˌmæstərˈbeɪʃən
taken=ˈteɪkən
serbian=ˈsərbiən
lamb=læm
impress=ᵻmˈprɛs
ward=wɔrd
venue=ˈvɛnˌju
plasma=ˈplæzmə
intend=ᵻnˈtɛnd
telecom=ˈtɛləˌkɑm
harmony=ˈhɑrməni
respect=rəˈspɛk(t)
worm=wərm
donate=ˈdoʊˌneɪt
regime=reɪˈʒim
sampling=ˈsæmp(ə)lɪŋ
mistress=ˈmɪstrəs
franklin=ˈfræŋklən
gotten=ˈɡɑtn
org=ɔrɡ
transport=ˈtræn(t)sˌpɔrt
jim=dʒɪm
locally=ˈloʊkəli
philippine=ˈfɪləˌpin
fig=fɪɡ
eight=eɪt
actress=ˈæktrəs
mostly=ˈmoʊs(t)li
characteristic=ˌkɛr(ə)ktəˈrɪstɪk
richardson=ˈrɪtʃərds(ə)n
christmas=ˈkrɪsməs
meant=mɛnt
austrian=ˈɔstriən
void=vɔɪd
hacker=ˈhækər
lance=læn(t)s
famous=ˈfeɪməs
wisconsin=wəˈskɑn(t)s(ə)n
settlement=ˈsɛdlmənt
permission=pərˈmɪʃən
bridal=ˈbraɪdəl
champagne=ʃæmˈpeɪn
administration=ədˌmɪnəˈstreɪʃən
cleaner=ˈklinər
herself=hərˈsɛlf
nightlife=ˈnaɪtˌlaɪf
prevent=priˈvɛnt
jew=dʒu
ambient=ˈæmbiənt
maximon=ˈmæksəˌmɑn
co-ordination=koʊˌɔrdɪˈneɪʃən
documentation=ˌdɑkjəmənˈteɪʃən
hand-hold=ˈhæn(d)ˌ(h)oʊld
jones=dʒoʊnz
struggle=ˈstrəɡ(ə)l
minimize=ˈmɪnəˌmaɪz
solution=səˈluʃən
glove=ɡləv
disaster=dəˈzæstər
breakdown=ˈbreɪkˌdaʊn
omaha=ˈoʊməˌhɑ
lambda=ˈlæmdə
paint=peɪnt
wound=wund
important=ᵻmˈpɔrt(ə)nt
eval=ˈiːvəl
skype=skaɪp
walk=wɔk
retro=ˈrɛtroʊ
taxi=ˈtæksi
settle=ˈsɛd(ə)l
there=ðɛ(ə)r
truly=ˈtruli
zinc=zɪŋk
mad=mæd
barely=ˈbɛrli
physically=ˈfɪzək(ə)li
chrome=kroʊm
deal=dil
invention=ᵻnˈvɛnʃən
couldn't=ˈkʊdnt
klingon=ˈklɪŋɑn
softball=ˈsɔf(t)ˌbɔl
antenna=ænˈtɛnə
didn't=ˈdɪd(ə)n(t)
nickname=ˈnɪkˌneɪm
dutch=dətʃ
closely=ˈkloʊsli
home-page=ˈhoʊm ˌpeɪdʒ
nobody=ˈnoʊˌbɑdi
ribbon=ˈrɪbən
constitute=ˈkɑn(t)stəˌt(j)ut
resistance=rəˈzɪst(ə)n(t)s
aryan=ˈɛriən
upon=əˈpɑn
propose=prəˈpoʊz
civic=ˈsɪvɪk
arabia=əˈreɪbiə
structure=ˈstrək(t)ʃər
visit=ˈvɪzᵻt
license=ˈlaɪsn(t)s
quite=kwaɪt
gentle=ˈdʒɛn(t)əl
either=ˈiðər
agreement=əˈɡrim(ə)nt
gamboge=ɡæmˈboʊdʒ
fellowship=ˈfɛloʊˌʃɪp
broken=ˈbroʊkən
micelle=məˈsɛl
more=mɔr
gossip=ˈɡɑsəp
printable=ˈprɪn(t)əb(ə)l
enormous=ᵻˈnɔrməs
roulette=ruˈlɛt
gun=ɡən
fridge=frɪdʒ
courtesy=ˈkərdəsi
sculpture=ˈskəlptʃər
locale=ˌloʊˈkæl
produce=prəˈd(j)us
meanwhile=ˈminˌ(h)waɪl
piss=pɪs
music=ˈmjuzɪk
rico=ˈrikoʊ
ken=kɛn
commodity=kəˈmɑdədi
disciplinary=ˈdɪsəpləˌnɛri
haven=ˈheɪv(ə)n
paris=ˈpɛrəs
currency=ˈkərən(t)si
mercy=ˈmərsi
cuento=ˈkwɛn(t)oʊ
regardless=rəˈɡɑrdləs
british=ˈbrɪdɪʃ
modern=ˈmɑdərn
availability=əˌveɪləˈbɪlᵻdi
security=səˈkjʊrədi
sego=ˈsiɡoʊ
wooden=ˈwʊd(ə)n
database=ˈdædəˌbeɪs
identify=aɪˈdɛn(t)əˌfaɪ
trader=ˈtreɪdər
cod=kɑd
excessive=ɪkˈsɛsɪv
incentive=ᵻnˈsɛn(t)ɪv
calculate=ˈkælkjəˌleɪt
bird=bərd
char=tʃɑr
pre=pri
sudan=suˈdæn
scoop=skup
cognitive=ˈkɑɡnədɪv
steer=stɪ(ə)r
alumnus=əˈləmnəs
maritime=ˈmɛrəˌtaɪm
harm=hɑrm
sierra=siˈɛrə
integration=ˌɪn(t)əˈɡreɪʃən
owen=ˈoʊ(w)ən
chelsea=ˈtʃɛlsiː
aspect=ˈæˌspɛk(t)
brisance=ˈbriːzɒns
argentine=ˈɑrdʒənˌtin
tobacco=təˈbækoʊ
spirituality=ˌspɪrᵻtʃəˈwælədi
perfume=ˈpərˌfjum
alp=ælp
period=ˈpɪriəd
durable=ˈd(j)ʊrəb(ə)l
fly=flaɪ
threat=θrɛt
list=lɪst
monster=ˈmɑn(t)stər
adas=ˈeɪˌdæs
join=dʒɔɪn
highland=ˈhaɪlənd
calvados=ˈkælvəˌdoʊs
munich=ˈmjunɪk
commit=kəˈmɪt
authentication=əˌθɛn(t)əˈkeɪʃən
sex=sɛks
inch=ɪn(t)ʃ
analogue=ˈænlˌɔɡ
apart=əˈpɑrt
reasonable=ˈrizn̩əb(ə)l
very=ˈvɛri
gasoline=ˈɡæsəlin
nominate=ˈnɑməˌneɪt
duo=ˈd(j)uoʊ
literary=ˈlɪdəˌrɛri
bay=beɪ
lite=laɪt
webster=ˈwɛbstər
irish=ˈaɪrɪʃ
scholar=ˈskɑlər
consider=kənˈsɪdər
give=ɡɪv
statistical=stəˈtɪstəkəl
studio=ˈst(j)udioʊ
home=hoʊm
lewis=ˈluəs
drew=dru
amenity=əˈmɛnədi
canny=ˈkæni
shade=ʃeɪd
european=ˌjərəˈpiən
buyer=ˈbaɪər
baby=ˈbeɪbi
estimate=ˈɛstəˌmeɪt
psi=(p)saɪ
legend=ˈlɛdʒənd
possible=ˈpɑsəb(ə)l
healthcare=ˈhɛlθˌkɛ(ə)r
kind=kaɪnd
crag=kræɡ
infra-red=ˌɪnf(r)əˈrɛd
harvest=ˈhɑrvəst
fleet=flit
fill=fɪl
sonic=ˈsɑnɪk
along=əˈlɔŋ
gently=ˈdʒɛn(t)li
voter=ˈvoʊdər
wind=wɪnd
suspect=səˈspɛk(t)
singapore=ˈsɪŋəˌpɔr
largely=ˈlɑrdʒli
password=ˈpæsˌwərd
horrible=ˈhɔrəb(ə)l
ram=ræm
eco=ˈikoʊ
language=ˈlæŋɡwɪdʒ
bouquet=boʊˈkeɪ
fame=feɪm
informal=ᵻnˈfɔrm(ə)l
witness=ˈwɪtnᵻs
connectivity=kəˌnɛkˈtɪvᵻdi
vanilla=vəˈnɪlə
phrase=freɪz
sage=seɪdʒ
violation=ˌvaɪəˈleɪʃən
register=ˈrɛdʒəstər
memphis=ˈmɛm(p)fəs
dos=dɔs
surely=ˈʃʊrli
britain=ˈbrɪtn
agricultural=ˌæɡrəˈkəltʃ(ə)rəl
intelligent=ᵻnˈtɛlədʒ(ə)nt
house=haʊs
sapphire=ˈsæˌfaɪ(ə)r
coin=kɔɪn
adobe=əˈdoʊbi
apartment=əˈpɑrtmənt
compress=kəmˈprɛs
doll=dɑl
own=oʊn
immediately=ᵻˈmidiətli
cute=kjut
official=əˈfɪʃ(ə)l
expectation=ˌɛkˌspɛkˈteɪʃən
newbie=ˈn(j)ubi
cortes=ˈkɔrtɛz
acceptance=əkˈsɛpt(ə)n(t)s
russian=ˈrəʃən
ted=tɛd
appropriate=əˈproʊpriət
bulgarian=ˌbəlˈɡɛriən
badge=bædʒ
feature=ˈfitʃər
principle=ˈprɪn(t)səp(ə)l
emperor=ˈɛmp(ə)rər
pollution=pəˈluʃən
locate=ˈloʊˌkeɪt
certain=ˈsərtn
fast=fæst
gay=ɡeɪ
namely=ˈneɪmli
assignment=əˈsaɪnmənt
vacancy=ˈveɪkən(t)si
violence=ˈvaɪ(ə)lən(t)s
strategic=strəˈtidʒɪk
booty=ˈbudi
race=reɪs
pink=pɪŋk
reef=rif
prediction=priˈdɪkʃən
oracy=ˈɔrəsi
north=nɔrθ
trouble=ˈtrəb(ə)l
bug=bəɡ
low-tech=ˈloʊˌtɛk
tracker=ˈtrækər
can't=kænt
investigator=ᵻnˈvɛstəˌɡeɪdər
invoice=ˈɪnˌvɔɪs
latino=ləˈtiˌnoʊ
cabinet=ˈkæb(ə)nət
institution=ˌɪn(t)stəˈt(j)uʃən
invalid=ᵻnˈvæləd
ingredient=ᵻnˈɡridiənt
rom=roʊm
illegal=ɪ(l)ˈliɡ(ə)l
scare=skɛ(ə)r
tex=tɛks
decision=dᵻˈsɪʒ(ə)n
secure=səˈkjʊ(ə)r
wouldst=wʊdst
teenage=ˈtiˌneɪdʒ
reserve=rəˈzərv
monte=ˈmɑn(t)eɪ
food=fud
palmer=ˈpɑ(l)mər
fare=fɛ(ə)r
maria=ˈmɑriə
blame=bleɪm
depot=ˈdiˌpoʊ
tomorrow=təˈmɑroʊ
youth=juθ
eliminate=əˈlɪməˌneɪt
sprint=sprɪnt
blade=bleɪd
lol=lɑl
jack=dʒæk
detail=dəˈteɪl
neither=ˈniðər
which=(h)wɪtʃ
statutory=ˈstætʃəˌtɔri
roller=ˈroʊlər
meditation=ˌmɛdəˈteɪʃən
originally=əˈrɪdʒ(ə)nəli
continuous=kənˈtɪnjəwəs
volost=ˈvəʊlə(ʊ)st
information=ˌɪnfərˈmeɪʃən
tamil=ˈtæm(ə)l
approximate=əˈprɑksəmət
noble=ˈnoʊb(ə)l
surname=ˈsərˌneɪm
groundwater=ˈɡraʊn(d)ˌwɔdər
flush=fləʃ
hack=hæk
waiver=ˈweɪvər
outlook=ˈaʊtˌlʊk
expertise=ˌɛkˌspərˈtiz
Patricia=pəˈtrɪʃə
Jennifer=ˈʤɛnəfər
Linda=ˈlɪndə
David=ˈdeɪvɪd
Elizabeth=ɪˈlɪzəbəθ
Susan=ˈsuzən
Jessica=ˈʤɛsɪkə
Charles=ʧɑrlz
Lisa=ˈlisə
Sandra=ˈsændrə
Ashley=ˈæʃli
Donald=ˈdɑnəld
Emily=ˈɛmɪli
Kimberly=ˈkɪmbərli
Michelle=mɪˈʃɛl
Kenneth=ˈkɛnɪθ
Kevin=ˈkɛvɪn
Amanda=əˈmændə
Brian=ˈbraɪən
Deborah=ˈdɛbərə
Ronald=ˈrɑnəld
Stephanie=ˈstɛfəni
Jason=ˈʤeɪsən
Sharon=ˈʃærən
Cynthia=ˈsɪnθiə
Ryan=ˈraɪən
Dorothy=ˈdɔrəθi
Amy=ˈeɪmi
Nicholas=ˈnɪkələs
Kathleen=kæˈθlin
Gary=ˈɡɛri
Angela=ˈænʤələ
Shirley=ˈʃɜrli
Stephen=ˈstivən
Brenda=ˈbrɛndə
Pamela=ˈpæmələ
Justin=ˈʤʌstən
Nicole=nɪˈkoʊl
Brandon=ˈbrændən
Samantha=səˈmænθə
Katherine=ˈkæθərɪn
Samuel=ˈsæmjul
Christine=krɪˈstin
Debra=ˈdɛbrə
Patrick=ˈpætrɪk
Carolyn=ˈkɛrəlɪn
Janet=ˈʤænət
Raymond=ˈreɪmənd
Olivia=oʊˈlɪviə
Dennis=ˈdɛnɪs
Helen=ˈhɛlən
Tyler=ˈtaɪlər
Diane=daɪˈæn
Jose=ˌhoʊˈzeɪ
Julie=ˈʤuli
Nathan=ˈneɪθən
Joyce=ʤɔɪs
Lauren=ˈlɔrən
Zachary=ˈzækəri
Douglas=ˈdʌɡləs
Christina=krɪˈstinə
Noah=ˈnoʊə
Ethan=ˈiθən
Judith=ˈʤudəθ
Jeremy=ˈʤɛrəmi
Evelyn=ˈɛvələn
Hannah=ˈhænə
Andrea=ˈændriə
Keith=kiθ
Megan=ˈmeɪɡən
Cheryl=ˈʃɛrəl
Jacqueline=ˈʤækwəlɪn
Sean=ʃɔn
Teresa=təˈrisə
Gerald=ˈʤɛrəld
Abigail=ˈæbəˌɡeɪl
Sophia=soʊˈfiə
Dylan=ˈdɪlən
Harold=ˈhɛrəld
Sara=ˈsɛrə
Gloria=ˈɡlɔriə
Janice=ˈʤænəs
Bryan=ˈbraɪən
Kathryn=ˈkæθrɪn
Lawrence=ˈlɔrəns
Bruce=brus
Logan=ˈloʊɡən
Juan=wɑn
Elijah=ɛˈlaɪʤə
Denise=dɪˈnis
Frances=ˈfrænsɪs
Wayne=weɪn
Marilyn=ˈmɛrələn
Natalie=ˈnætəli
Beverly=ˈbɛvərli
Liam=ˈliəm
Brittany=ˈbrɪtəni
Theresa=təˈrisə
Kayla=ˈkeɪlə
Caleb=ˈkeɪləb
Alexis=əˈlɛksɪs
Bradley=ˈbrædli
Doris=ˈdɔrəs
Lori=ˈlɔri
Martin=maʀtɛ̃
Bernard=bɛʀnaʀ
Robert=ʀɔbɛʀ
Richard=ʀiʃaʀ
Durand=dyʀɑ̃
Dubois=dybwa
Moreau=mɔʀo
Simon=simɔ̃
Laurent=lɔʀɑ̃
Michel=miʃɛl
Satō=satoː
Suzuki=suzuki
Takahashi=takahaʃi
Tanaka=tanaka
Watanabe=watanabe
Itō=itoː
Nakamura=nakamura
Kobayashi=kobaʃin
Yamamoto=jamboto
Katō=katoː
hernández=eɾˈnandes
garcía=gaɾˈsia
martínez=maɾˈtines
gonzález=gonˈsales
lópez=loˈpes
rodríguez=roˈðɾiɣes
pérez=peˈɾes
sánchez=sanˈtʃes
ramírez=raˈmiɾes
flores=floɾes
santiago=sanˈtjaɣo
mateo=maˈteo
leonardo=
matías=maˈtias
sebastian=sɪˈbæstʃɪn
emiliano=
diego=djeˈɣo
daniel=dænˈjəl
emilio=eˈmiljo
alejandro=aˈlexandɾo
sofía=soˈfia
regina=
valentina=baˈlentina
victoria=bikˈtoɾja
isabella=iˈsaβel
camila=kəˈmɪlə
mariana=
romina=roˈmina
renata=
natalia=næˈɾəli
